"시점","행정구역별(읍면동)","연령별",총인구(명),총인구_남자(명),총인구_여자(명)
"2015","전국","합계",51069375,25608502,25460873
"2015","전국","15~19세",3194079,1668683,1525396
"2015","전국","20~24세",3531108,1887776,1643332
"2015","전국","25~29세",3265288,1728888,1536400
"2015","전국","30~34세",3811610,1986796,1824814
"2015","전국","35~39세",3926862,2022466,1904396
"2015","전국","40~44세",4338827,2218442,2120385
"2015","전국","45~49세",4388157,2217013,2171144
"2015","전국","50~54세",4263447,2153186,2110261
"2015","전국","55~59세",3956849,1969232,1987617
"2015","전국","60~64세",2821457,1379694,1441763
"2015","전국","15세미만",6954313,3591551,3362762
"2015","전국","65세이상",6617378,2784775,3832603
"2015","서울특별시","합계",9904312,4859535,5044777
"2015","서울특별시","15~19세",551140,281128,270012
"2015","서울특별시","20~24세",711944,352341,359603
"2015","서울특별시","25~29세",765654,377599,388055
"2015","서울특별시","30~34세",857426,432854,424572
"2015","서울특별시","35~39세",793411,401512,391899
"2015","서울특별시","40~44세",836876,421126,415750
"2015","서울특별시","45~49세",824198,406727,417471
"2015","서울특별시","50~54세",806399,393503,412896
"2015","서울특별시","55~59세",783847,374379,409468
"2015","서울특별시","60~64세",582420,277581,304839
"2015","서울특별시","15세미만",1169991,602163,567828
"2015","서울특별시","65세이상",1221006,538622,682384
"2015","부산광역시","합계",3448737,1701347,1747390
"2015","부산광역시","15~19세",204961,107728,97233
"2015","부산광역시","20~24세",248602,132959,115643
"2015","부산광역시","25~29세",212741,111618,101123
"2015","부산광역시","30~34세",239683,123727,115956
"2015","부산광역시","35~39세",245563,126063,119500
"2015","부산광역시","40~44세",268002,134657,133345
"2015","부산광역시","45~49세",282139,137543,144596
"2015","부산광역시","50~54세",295246,141969,153277
"2015","부산광역시","55~59세",308539,147484,161055
"2015","부산광역시","60~64세",239182,114660,124522
"2015","부산광역시","15세미만",403274,208324,194950
"2015","부산광역시","65세이상",500805,214615,286190
"2015","대구광역시","합계",2466052,1228511,1237541
"2015","대구광역시","15~19세",166041,88179,77862
"2015","대구광역시","20~24세",179886,99182,80704
"2015","대구광역시","25~29세",147553,80981,66572
"2015","대구광역시","30~34세",164637,84206,80431
"2015","대구광역시","35~39세",178427,89710,88717
"2015","대구광역시","40~44세",210088,103561,106527
"2015","대구광역시","45~49세",223233,109810,113423
"2015","대구광역시","50~54세",217525,107366,110159
"2015","대구광역시","55~59세",196256,96598,99658
"2015","대구광역시","60~64세",143833,68842,74991
"2015","대구광역시","15세미만",326711,169951,156760
"2015","대구광역시","65세이상",311862,130125,181737
"2015","인천광역시","합계",2890451,1455017,1435434
"2015","인천광역시","15~19세",178680,92515,86165
"2015","인천광역시","20~24세",201475,106897,94578
"2015","인천광역시","25~29세",191414,99680,91734
"2015","인천광역시","30~34세",226657,118283,108374
"2015","인천광역시","35~39세",233734,121355,112379
"2015","인천광역시","40~44세",252877,129684,123193
"2015","인천광역시","45~49세",257583,128105,129478
"2015","인천광역시","50~54세",259355,130922,128433
"2015","인천광역시","55~59세",228142,115321,112821
"2015","인천광역시","60~64세",145648,72459,73189
"2015","인천광역시","15세미만",406846,209227,197619
"2015","인천광역시","65세이상",308040,130569,177471
"2015","광주광역시","합계",1502881,748867,754014
"2015","광주광역시","15~19세",113385,58626,54759
"2015","광주광역시","20~24세",118234,60865,57369
"2015","광주광역시","25~29세",94121,48775,45346
"2015","광주광역시","30~34세",110306,56574,53732
"2015","광주광역시","35~39세",117812,59316,58496
"2015","광주광역시","40~44세",132138,66368,65770
"2015","광주광역시","45~49세",131046,65889,65157
"2015","광주광역시","50~54세",117496,59081,58415
"2015","광주광역시","55~59세",104589,51584,53005
"2015","광주광역시","60~64세",70853,34236,36617
"2015","광주광역시","15세미만",226693,117445,109248
"2015","광주광역시","65세이상",166208,70108,96100
"2015","대전광역시","합계",1538394,772243,766151
"2015","대전광역시","15~19세",111778,58503,53275
"2015","대전광역시","20~24세",129333,69006,60327
"2015","대전광역시","25~29세",102960,55473,47487
"2015","대전광역시","30~34세",111896,57146,54750
"2015","대전광역시","35~39세",117076,58510,58566
"2015","대전광역시","40~44세",131185,65652,65533
"2015","대전광역시","45~49세",132439,66027,66412
"2015","대전광역시","50~54세",124062,62074,61988
"2015","대전광역시","55~59세",112837,56067,56770
"2015","대전광역시","60~64세",76905,37934,38971
"2015","대전광역시","15세미만",223618,115467,108151
"2015","대전광역시","65세이상",164305,70384,93921
"2015","울산광역시","합계",1166615,606924,559691
"2015","울산광역시","15~19세",77393,42198,35195
"2015","울산광역시","20~24세",79289,46427,32862
"2015","울산광역시","25~29세",75299,42924,32375
"2015","울산광역시","30~34세",91323,49294,42029
"2015","울산광역시","35~39세",93835,49651,44184
"2015","울산광역시","40~44세",101733,51327,50406
"2015","울산광역시","45~49세",111764,56073,55691
"2015","울산광역시","50~54세",108010,56240,51770
"2015","울산광역시","55~59세",92333,47354,44979
"2015","울산광역시","60~64세",60131,30765,29366
"2015","울산광역시","15세미만",174141,90750,83391
"2015","울산광역시","65세이상",101364,43921,57443
"2015","세종특별자치시","합계",204088,103210,100878
"2015","세종특별자치시","15~19세",11981,6032,5949
"2015","세종특별자치시","20~24세",14433,7886,6547
"2015","세종특별자치시","25~29세",12090,6585,5505
"2015","세종특별자치시","30~34세",17322,8388,8934
"2015","세종특별자치시","35~39세",20153,10033,10120
"2015","세종특별자치시","40~44세",19823,10500,9323
"2015","세종특별자치시","45~49세",14761,8031,6730
"2015","세종특별자치시","50~54세",12815,6742,6073
"2015","세종특별자치시","55~59세",11545,5877,5668
"2015","세종특별자치시","60~64세",8351,4151,4200
"2015","세종특별자치시","15세미만",39711,20241,19470
"2015","세종특별자치시","65세이상",21103,8744,12359
"2015","경기도","합계",12479061,6309661,6169400
"2015","경기도","15~19세",791805,409613,382192
"2015","경기도","20~24세",841409,447814,393595
"2015","경기도","25~29세",807673,429154,378519
"2015","경기도","30~34세",974298,508729,465569
"2015","경기도","35~39세",1045587,536301,509286
"2015","경기도","40~44세",1159219,592425,566794
"2015","경기도","45~49세",1134981,574171,560810
"2015","경기도","50~54세",1054682,540691,513991
"2015","경기도","55~59세",900787,458719,442068
"2015","경기도","60~64세",588180,292108,296072
"2015","경기도","15세미만",1878632,966859,911773
"2015","경기도","65세이상",1301808,553077,748731
"2015","강원특별자치도","합계",1518040,768241,749799
"2015","강원특별자치도","15~19세",97756,52068,45688
"2015","강원특별자치도","20~24세",107921,62790,45131
"2015","강원특별자치도","25~29세",80314,45570,34744
"2015","강원특별자치도","30~34세",88552,46803,41749
"2015","강원특별자치도","35~39세",97761,49940,47821
"2015","강원특별자치도","40~44세",117324,60850,56474
"2015","강원특별자치도","45~49세",124735,65031,59704
"2015","강원특별자치도","50~54세",128399,65544,62855
"2015","강원특별자치도","55~59세",131865,66279,65586
"2015","강원특별자치도","60~64세",94841,47060,47781
"2015","강원특별자치도","15세미만",193769,100218,93551
"2015","강원특별자치도","65세이상",254803,106088,148715
"2015","충청북도","합계",1589347,805377,783970
"2015","충청북도","15~19세",106539,55891,50648
"2015","충청북도","20~24세",113414,62172,51242
"2015","충청북도","25~29세",94540,52293,42247
"2015","충청북도","30~34세",108441,57870,50571
"2015","충청북도","35~39세",112462,59055,53407
"2015","충청북도","40~44세",125782,65379,60403
"2015","충청북도","45~49세",134300,69105,65195
"2015","충청북도","50~54세",131746,68133,63613
"2015","충청북도","55~59세",124779,63493,61286
"2015","충청북도","60~64세",89402,44393,45009
"2015","충청북도","15세미만",217409,112310,105099
"2015","충청북도","65세이상",230533,95283,135250
"2015","충청남도","합계",2107802,1078310,1029492
"2015","충청남도","15~19세",135925,71225,64700
"2015","충청남도","20~24세",144660,77338,67322
"2015","충청남도","25~29세",127182,71035,56147
"2015","충청남도","30~34세",152421,84202,68219
"2015","충청남도","35~39세",157002,85050,71952
"2015","충청남도","40~44세",167392,90009,77383
"2015","충청남도","45~49세",164903,87551,77352
"2015","충청남도","50~54세",164283,86760,77523
"2015","충청남도","55~59세",151924,77372,74552
"2015","충청남도","60~64세",113309,56034,57275
"2015","충청남도","15세미만",296037,153109,142928
"2015","충청남도","65세이상",332764,138625,194139
"2015","전라북도","합계",1834114,915729,918385
"2015","전라북도","15~19세",123926,65504,58422
"2015","전라북도","20~24세",126300,69322,56978
"2015","전라북도","25~29세",97765,52875,44890
"2015","전라북도","30~34세",109359,57328,52031
"2015","전라북도","35~39세",120792,62471,58321
"2015","전라북도","40~44세",143138,74161,68977
"2015","전라북도","45~49세",146666,75918,70748
"2015","전라북도","50~54세",145400,74578,70822
"2015","전라북도","55~59세",141381,70761,70620
"2015","전라북도","60~64세",108527,53536,54991
"2015","전라북도","15세미만",246497,127325,119172
"2015","전라북도","65세이상",324363,131950,192413
"2015","전라남도","합계",1799044,900967,898077
"2015","전라남도","15~19세",111028,58971,52057
"2015","전라남도","20~24세",99301,57132,42169
"2015","전라남도","25~29세",83731,45144,38587
"2015","전라남도","30~34세",103927,55536,48391
"2015","전라남도","35~39세",113927,60234,53693
"2015","전라남도","40~44세",133103,71313,61790
"2015","전라남도","45~49세",144423,77553,66870
"2015","전라남도","50~54세",145762,76357,69405
"2015","전라남도","55~59세",143786,73280,70506
"2015","전라남도","60~64세",110438,54732,55706
"2015","전라남도","15세미만",237267,122258,115009
"2015","전라남도","65세이상",372351,148457,223894
"2015","경상북도","합계",2680294,1351037,1329257
"2015","경상북도","15~19세",163791,88104,75687
"2015","경상북도","20~24세",171458,96526,74932
"2015","경상북도","25~29세",149623,84374,65249
"2015","경상북도","30~34세",174478,93893,80585
"2015","경상북도","35~39세",179540,95089,84451
"2015","경상북도","40~44세",203175,106270,96905
"2015","경상북도","45~49세",216380,112189,104191
"2015","경상북도","50~54세",224043,114892,109151
"2015","경상북도","55~59세",220294,110636,109658
"2015","경상북도","60~64세",171410,83454,87956
"2015","경상북도","15세미만",337066,175781,161285
"2015","경상북도","65세이상",469036,189829,279207
"2015","경상남도","합계",3334524,1698737,1635787
"2015","경상남도","15~19세",208104,111484,96620
"2015","경상남도","20~24세",204793,118127,86666
"2015","경상남도","25~29세",190156,107800,82356
"2015","경상남도","30~34세",239910,130761,109149
"2015","경상남도","35~39세",254746,134816,119930
"2015","경상남도","40~44세",283354,147342,136012
"2015","경상남도","45~49세",291991,149791,142200
"2015","경상남도","50~54세",279912,143426,136486
"2015","경상남도","55~59세",260678,132062,128616
"2015","경상남도","60~64세",187560,92785,94775
"2015","경상남도","15세미만",479761,249644,230117
"2015","경상남도","65세이상",453559,180699,272860
"2015","제주특별자치도","합계",605619,304789,300830
"2015","제주특별자치도","15~19세",39846,20914,18932
"2015","제주특별자치도","20~24세",38656,20992,17664
"2015","제주특별자치도","25~29세",32472,17008,15464
"2015","제주특별자치도","30~34세",40974,21202,19772
"2015","제주특별자치도","35~39세",45034,23360,21674
"2015","제주특별자치도","40~44세",53618,27818,25800
"2015","제주특별자치도","45~49세",52615,27499,25116
"2015","제주특별자치도","50~54세",48312,24908,23404
"2015","제주특별자치도","55~59세",43267,21966,21301
"2015","제주특별자치도","60~64세",30467,14964,15503
"2015","제주특별자치도","15세미만",96890,50479,46411
"2015","제주특별자치도","65세이상",83468,33679,49789
"2016","전국","합계",51269554,25696987,25572567
"2016","전국","15~19세",3084039,1606802,1477237
"2016","전국","20~24세",3552780,1898134,1654646
"2016","전국","25~29세",3308184,1756218,1551966
"2016","전국","30~34세",3629317,1894497,1734820
"2016","전국","35~39세",4002467,2062739,1939728
"2016","전국","40~44세",4152420,2124144,2028276
"2016","전국","45~49세",4492909,2264120,2228789
"2016","전국","50~54세",4153936,2108614,2045322
"2016","전국","55~59세",4165508,2069976,2095532
"2016","전국","60~64세",3079213,1508112,1571101
"2016","전국","15세미만",6822213,3518101,3304112
"2016","전국","65세이상",6826568,2885530,3941038
"2016","서울특별시","합계",9805506,4799115,5006391
"2016","서울특별시","15~19세",526432,267296,259136
"2016","서울특별시","20~24세",707555,346503,361052
"2016","서울특별시","25~29세",761584,375184,386400
"2016","서울특별시","30~34세",807246,405165,402081
"2016","서울특별시","35~39세",798944,403974,394970
"2016","서울특별시","40~44세",789416,396847,392569
"2016","서울특별시","45~49세",842448,414847,427601
"2016","서울특별시","50~54세",773918,380832,393086
"2016","서울특별시","55~59세",795249,379327,415922
"2016","서울특별시","60~64세",624370,296875,327495
"2016","서울특별시","15세미만",1130398,581228,549170
"2016","서울특별시","65세이상",1247946,551037,696909
"2016","부산광역시","합계",3440484,1694026,1746458
"2016","부산광역시","15~19세",194712,101759,92953
"2016","부산광역시","20~24세",245825,130739,115086
"2016","부산광역시","25~29세",213370,111928,101442
"2016","부산광역시","30~34세",224194,115989,108205
"2016","부산광역시","35~39세",253126,130038,123088
"2016","부산광역시","40~44세",254784,128753,126031
"2016","부산광역시","45~49세",284928,138850,146078
"2016","부산광역시","50~54세",279576,135609,143967
"2016","부산광역시","55~59세",315908,150135,165773
"2016","부산광역시","60~64세",254676,121730,132946
"2016","부산광역시","15세미만",395647,204000,191647
"2016","부산광역시","65세이상",523738,224496,299242
"2016","대구광역시","합계",2461002,1223733,1237269
"2016","대구광역시","15~19세",157832,83207,74625
"2016","대구광역시","20~24세",178227,97665,80562
"2016","대구광역시","25~29세",149598,82378,67220
"2016","대구광역시","30~34세",155362,80524,74838
"2016","대구광역시","35~39세",179830,90213,89617
"2016","대구광역시","40~44세",199464,98620,100844
"2016","대구광역시","45~49세",225880,110673,115207
"2016","대구광역시","50~54세",210583,104161,106422
"2016","대구광역시","55~59세",206933,101399,105534
"2016","대구광역시","60~64세",154574,74135,80439
"2016","대구광역시","15세미만",318450,165138,153312
"2016","대구광역시","65세이상",324269,135620,188649
"2016","인천광역시","합계",2913024,1465699,1447325
"2016","인천광역시","15~19세",172119,88867,83252
"2016","인천광역시","20~24세",200319,106207,94112
"2016","인천광역시","25~29세",196261,102669,93592
"2016","인천광역시","30~34세",215786,112731,103055
"2016","인천광역시","35~39세",241311,125265,116046
"2016","인천광역시","40~44세",243144,125017,118127
"2016","인천광역시","45~49세",262988,130951,132037
"2016","인천광역시","50~54세",252565,127011,125554
"2016","인천광역시","55~59세",244514,123563,120951
"2016","인천광역시","60~64세",163424,81238,82186
"2016","인천광역시","15세미만",400765,205942,194823
"2016","인천광역시","65세이상",319828,136238,183590
"2016","광주광역시","합계",1501557,747303,754254
"2016","광주광역시","15~19세",108159,55626,52533
"2016","광주광역시","20~24세",119181,61847,57334
"2016","광주광역시","25~29세",93810,48861,44949
"2016","광주광역시","30~34세",103257,53030,50227
"2016","광주광역시","35~39세",117658,58976,58682
"2016","광주광역시","40~44세",126485,63576,62909
"2016","광주광역시","45~49세",134150,67154,66996
"2016","광주광역시","50~54세",117447,59303,58144
"2016","광주광역시","55~59세",111120,54780,56340
"2016","광주광역시","60~64세",75538,36728,38810
"2016","광주광역시","15세미만",219754,113741,106013
"2016","광주광역시","65세이상",174998,73681,101317
"2016","대전광역시","합계",1535445,770971,764474
"2016","대전광역시","15~19세",107174,56028,51146
"2016","대전광역시","20~24세",130171,69372,60799
"2016","대전광역시","25~29세",104574,56827,47747
"2016","대전광역시","30~34세",106200,54786,51414
"2016","대전광역시","35~39세",117611,58980,58631
"2016","대전광역시","40~44세",124435,62183,62252
"2016","대전광역시","45~49세",136168,67626,68542
"2016","대전광역시","50~54세",118332,59524,58808
"2016","대전광역시","55~59세",119005,58831,60174
"2016","대전광역시","60~64세",84594,41679,42915
"2016","대전광역시","15세미만",216008,111720,104288
"2016","대전광역시","65세이상",171173,73415,97758
"2016","울산광역시","합계",1166033,605618,560415
"2016","울산광역시","15~19세",73137,39835,33302
"2016","울산광역시","20~24세",78196,46055,32141
"2016","울산광역시","25~29세",76427,43427,33000
"2016","울산광역시","30~34세",85927,46315,39612
"2016","울산광역시","35~39세",96413,51058,45355
"2016","울산광역시","40~44세",95932,48662,47270
"2016","울산광역시","45~49세",111218,55095,56123
"2016","울산광역시","50~54세",105923,55295,50628
"2016","울산광역시","55~59세",98668,50553,48115
"2016","울산광역시","60~64세",65981,33528,32453
"2016","울산광역시","15세미만",171136,88940,82196
"2016","울산광역시","65세이상",107075,46855,60220
"2016","세종특별자치시","합계",242507,122648,119859
"2016","세종특별자치시","15~19세",14111,7183,6928
"2016","세종특별자치시","20~24세",17254,9452,7802
"2016","세종특별자치시","25~29세",14806,7947,6859
"2016","세종특별자치시","30~34세",19952,9779,10173
"2016","세종특별자치시","35~39세",24898,12290,12608
"2016","세종특별자치시","40~44세",23274,12194,11080
"2016","세종특별자치시","45~49세",18891,10272,8619
"2016","세종특별자치시","50~54세",14335,7558,6777
"2016","세종특별자치시","55~59세",13770,6953,6817
"2016","세종특별자치시","60~64세",10247,5070,5177
"2016","세종특별자치시","15세미만",47977,24338,23639
"2016","세종특별자치시","65세이상",22992,9612,13380
"2016","경기도","합계",12671956,6405301,6266655
"2016","경기도","15~19세",774124,399498,374626
"2016","경기도","20~24세",850579,454093,396486
"2016","경기도","25~29세",834467,444835,389632
"2016","경기도","30~34세",939423,492343,447080
"2016","경기도","35~39세",1073515,551432,522083
"2016","경기도","40~44세",1119278,572150,547128
"2016","경기도","45~49세",1176250,592917,583333
"2016","경기도","50~54세",1047131,537301,509830
"2016","경기도","55~59세",971760,493228,478532
"2016","경기도","60~64세",663883,330267,333616
"2016","경기도","15세미만",1862289,957208,905081
"2016","경기도","65세이상",1359257,580029,779228
"2016","강원특별자치도","합계",1521751,769461,752290
"2016","강원특별자치도","15~19세",94329,50246,44083
"2016","강원특별자치도","20~24세",109384,62987,46397
"2016","강원특별자치도","25~29세",82158,46644,35514
"2016","강원특별자치도","30~34세",84544,45018,39526
"2016","강원특별자치도","35~39세",98366,50256,48110
"2016","강원특별자치도","40~44세",111842,57895,53947
"2016","강원특별자치도","45~49세",126043,65377,60666
"2016","강원특별자치도","50~54세",123781,63750,60031
"2016","강원특별자치도","55~59세",138849,69577,69272
"2016","강원특별자치도","60~64세",106474,53218,53256
"2016","강원특별자치도","15세미만",187589,96683,90906
"2016","강원특별자치도","65세이상",258392,107810,150582
"2016","충청북도","합계",1603404,814049,789355
"2016","충청북도","15~19세",103069,54018,49051
"2016","충청북도","20~24세",119018,65689,53329
"2016","충청북도","25~29세",96743,54042,42701
"2016","충청북도","30~34세",105171,56451,48720
"2016","충청북도","35~39세",113582,59855,53727
"2016","충청북도","40~44세",121128,62923,58205
"2016","충청북도","45~49세",135838,69737,66101
"2016","충청북도","50~54세",127449,66108,61341
"2016","충청북도","55~59세",133712,67906,65806
"2016","충청북도","60~64세",99665,49872,49793
"2016","충청북도","15세미만",212733,109770,102963
"2016","충청북도","65세이상",235296,97678,137618
"2016","충청남도","합계",2132566,1091091,1041475
"2016","충청남도","15~19세",133487,69607,63880
"2016","충청남도","20~24세",149280,79892,69388
"2016","충청남도","25~29세",128291,71924,56367
"2016","충청남도","30~34세",147304,81133,66171
"2016","충청남도","35~39세",161684,87950,73734
"2016","충청남도","40~44세",162513,87050,75463
"2016","충청남도","45~49세",172448,91787,80661
"2016","충청남도","50~54세",157710,83553,74157
"2016","충청남도","55~59세",162864,83190,79674
"2016","충청남도","60~64세",123639,61406,62233
"2016","충청남도","15세미만",292661,150964,141697
"2016","충청남도","65세이상",340685,142635,198050
"2016","전라북도","합계",1833168,915493,917675
"2016","전라북도","15~19세",120958,63887,57071
"2016","전라북도","20~24세",128596,70624,57972
"2016","전라북도","25~29세",97731,52950,44781
"2016","전라북도","30~34세",103957,54309,49648
"2016","전라북도","35~39세",120642,62417,58225
"2016","전라북도","40~44세",136336,70471,65865
"2016","전라북도","45~49세",149650,77422,72228
"2016","전라북도","50~54세",141728,73288,68440
"2016","전라북도","55~59세",148028,73974,74054
"2016","전라북도","60~64세",114907,56920,57987
"2016","전라북도","15세미만",238623,123331,115292
"2016","전라북도","65세이상",332012,135900,196112
"2016","전라남도","합계",1796017,901500,894517
"2016","전라남도","15~19세",107750,57555,50195
"2016","전라남도","20~24세",101073,58731,42342
"2016","전라남도","25~29세",84706,46084,38622
"2016","전라남도","30~34세",99547,52943,46604
"2016","전라남도","35~39세",114648,60637,54011
"2016","전라남도","40~44세",126353,67487,58866
"2016","전라남도","45~49세",145244,77597,67647
"2016","전라남도","50~54세",143411,76193,67218
"2016","전라남도","55~59세",151448,76939,74509
"2016","전라남도","60~64세",114484,56849,57635
"2016","전라남도","15세미만",231160,118878,112282
"2016","전라남도","65세이상",376193,151607,224586
"2016","경상북도","합계",2682169,1354997,1327172
"2016","경상북도","15~19세",158144,85047,73097
"2016","경상북도","20~24세",173588,98237,75351
"2016","경상북도","25~29세",148881,84582,64299
"2016","경상북도","30~34세",165123,89308,75815
"2016","경상북도","35~39세",182569,96826,85743
"2016","경상북도","40~44세",194693,101680,93013
"2016","경상북도","45~49세",217960,112990,104970
"2016","경상북도","50~54세",216891,112019,104872
"2016","경상북도","55~59세",230618,116305,114313
"2016","경상북도","60~64세",184790,90674,94116
"2016","경상북도","15세미만",329868,171857,158011
"2016","경상북도","65세이상",479044,195472,283572
"2016","경상남도","합계",3339633,1701849,1637784
"2016","경상남도","15~19세",199413,106634,92779
"2016","경상남도","20~24세",205082,118416,86666
"2016","경상남도","25~29세",190435,108016,82419
"2016","경상남도","30~34세",226227,123978,102249
"2016","경상남도","35~39세",260054,138078,121976
"2016","경상남도","40~44세",270635,141078,129557
"2016","경상남도","45~49세",297162,151815,145347
"2016","경상남도","50~54세",272906,140932,131974
"2016","경상남도","55~59세",276978,139961,137017
"2016","경상남도","60~64세",203934,101137,102797
"2016","경상남도","15세미만",469861,243743,226118
"2016","경상남도","65세이상",466946,188061,278885
"2016","제주특별자치도","합계",623332,314133,309199
"2016","제주특별자치도","15~19세",39089,20509,18580
"2016","제주특별자치도","20~24세",39452,21625,17827
"2016","제주특별자치도","25~29세",34342,17920,16422
"2016","제주특별자치도","30~34세",40097,20695,19402
"2016","제주특별자치도","35~39세",47616,24494,23122
"2016","제주특별자치도","40~44세",52708,27558,25150
"2016","제주특별자치도","45~49세",55643,29010,26633
"2016","제주특별자치도","50~54세",50250,26177,24073
"2016","제주특별자치도","55~59세",46084,23355,22729
"2016","제주특별자치도","60~64세",34033,16786,17247
"2016","제주특별자치도","15세미만",97294,50620,46674
"2016","제주특별자치도","65세이상",86724,35384,51340
"2017","전국","합계",51422507,25768055,25654452
"2017","전국","15~19세",2922140,1523741,1398399
"2017","전국","20~24세",3517690,1872652,1645038
"2017","전국","25~29세",3407757,1815686,1592071
"2017","전국","30~34세",3447773,1804860,1642913
"2017","전국","35~39세",4070681,2100211,1970470
"2017","전국","40~44세",4037048,2060634,1976414
"2017","전국","45~49세",4532957,2295736,2237221
"2017","전국","50~54세",4122551,2082358,2040193
"2017","전국","55~59세",4258232,2120781,2137451
"2017","전국","60~64세",3251699,1596954,1654745
"2017","전국","15세미만",6682752,3441958,3240794
"2017","전국","65세이상",7171227,3052484,4118743
"2017","서울특별시","합계",9741871,4757642,4984229
"2017","서울특별시","15~19세",496075,251735,244340
"2017","서울특별시","20~24세",699945,338539,361406
"2017","서울특별시","25~29세",777218,383505,393713
"2017","서울특별시","30~34세",766607,384052,382555
"2017","서울특별시","35~39세",806213,407731,398482
"2017","서울특별시","40~44세",756546,378503,378043
"2017","서울특별시","45~49세",847475,419571,427904
"2017","서울특별시","50~54세",756194,370127,386067
"2017","서울특별시","55~59세",790279,378648,411631
"2017","서울특별시","60~64세",645887,306492,339395
"2017","서울특별시","15세미만",1089367,559449,529918
"2017","서울특별시","65세이상",1310065,579290,730775
"2017","부산광역시","합계",3416918,1680933,1735985
"2017","부산광역시","15~19세",182238,95018,87220
"2017","부산광역시","20~24세",240049,126463,113586
"2017","부산광역시","25~29세",218670,115467,103203
"2017","부산광역시","30~34세",208550,107923,100627
"2017","부산광역시","35~39세",255424,131196,124228
"2017","부산광역시","40~44세",244934,123941,120993
"2017","부산광역시","45~49세",282671,139262,143409
"2017","부산광역시","50~54세",270775,130892,139883
"2017","부산광역시","55~59세",313603,149182,164421
"2017","부산광역시","60~64세",264249,125995,138254
"2017","부산광역시","15세미만",385021,198417,186604
"2017","부산광역시","65세이상",550734,237177,313557
"2017","대구광역시","합계",2453041,1218326,1234715
"2017","대구광역시","15~19세",147500,77903,69597
"2017","대구광역시","20~24세",174218,94590,79628
"2017","대구광역시","25~29세",155003,85155,69848
"2017","대구광역시","30~34세",146261,76811,69450
"2017","대구광역시","35~39세",180724,90576,90148
"2017","대구광역시","40~44세",191103,94604,96499
"2017","대구광역시","45~49세",224449,110254,114195
"2017","대구광역시","50~54세",208698,102629,106069
"2017","대구광역시","55~59세",211613,103733,107880
"2017","대구광역시","60~64세",160684,77547,83137
"2017","대구광역시","15세미만",310683,160672,150011
"2017","대구광역시","65세이상",342105,143852,198253
"2017","인천광역시","합계",2925967,1472081,1453886
"2017","인천광역시","15~19세",162955,84290,78665
"2017","인천광역시","20~24세",197084,104667,92417
"2017","인천광역시","25~29세",204316,107177,97139
"2017","인천광역시","30~34세",204842,107338,97504
"2017","인천광역시","35~39세",245608,127772,117836
"2017","인천광역시","40~44세",236594,121708,114886
"2017","인천광역시","45~49세",264819,132593,132226
"2017","인천광역시","50~54세",248976,124334,124642
"2017","인천광역시","55~59세",253235,127747,125488
"2017","인천광역시","60~64세",175988,87511,88477
"2017","인천광역시","15세미만",391947,201105,190842
"2017","인천광역시","65세이상",339603,145839,193764
"2017","광주광역시","합계",1496172,745122,751050
"2017","광주광역시","15~19세",101974,52426,49548
"2017","광주광역시","20~24세",119367,62113,57254
"2017","광주광역시","25~29세",97045,50937,46108
"2017","광주광역시","30~34세",95426,49153,46273
"2017","광주광역시","35~39세",118159,59325,58834
"2017","광주광역시","40~44세",122387,61443,60944
"2017","광주광역시","45~49세",135394,67815,67579
"2017","광주광역시","50~54세",118620,59695,58925
"2017","광주광역시","55~59세",112903,55781,57122
"2017","광주광역시","60~64세",79969,38949,41020
"2017","광주광역시","15세미만",213034,110277,102757
"2017","광주광역시","65세이상",181894,77208,104686
"2017","대전광역시","합계",1525849,765718,760131
"2017","대전광역시","15~19세",100929,53119,47810
"2017","대전광역시","20~24세",129500,68272,61228
"2017","대전광역시","25~29세",107541,58575,48966
"2017","대전광역시","30~34세",99955,51950,48005
"2017","대전광역시","35~39세",117258,58975,58283
"2017","대전광역시","40~44세",119963,59653,60310
"2017","대전광역시","45~49세",135868,67710,68158
"2017","대전광역시","50~54세",116530,58423,58107
"2017","대전광역시","55~59세",120940,59704,61236
"2017","대전광역시","60~64세",89692,44318,45374
"2017","대전광역시","15세미만",208072,107318,100754
"2017","대전광역시","65세이상",179601,77701,101900
"2017","울산광역시","합계",1157077,600093,556984
"2017","울산광역시","15~19세",67585,36583,31002
"2017","울산광역시","20~24세",75679,44291,31388
"2017","울산광역시","25~29세",76201,43260,32941
"2017","울산광역시","30~34세",79461,42926,36535
"2017","울산광역시","35~39세",97287,51408,45879
"2017","울산광역시","40~44세",92872,47481,45391
"2017","울산광역시","45~49세",109101,54251,54850
"2017","울산광역시","50~54세",105196,54224,50972
"2017","울산광역시","55~59세",101675,52379,49296
"2017","울산광역시","60~64세",70485,35647,34838
"2017","울산광역시","15세미만",167117,86919,80198
"2017","울산광역시","65세이상",114418,50724,63694
"2017","세종특별자치시","합계",276589,139347,137242
"2017","세종특별자치시","15~19세",15821,8030,7791
"2017","세종특별자치시","20~24세",18151,9868,8283
"2017","세종특별자치시","25~29세",16675,8784,7891
"2017","세종특별자치시","30~34세",21563,10463,11100
"2017","세종특별자치시","35~39세",29326,14358,14968
"2017","세종특별자치시","40~44세",26892,13841,13051
"2017","세종특별자치시","45~49세",22720,12308,10412
"2017","세종특별자치시","50~54세",16342,8520,7822
"2017","세종특별자치시","55~59세",15936,8098,7838
"2017","세종특별자치시","60~64세",12034,5994,6040
"2017","세종특별자치시","15세미만",55731,28320,27411
"2017","세종특별자치시","65세이상",25398,10763,14635
"2017","경기도","합계",12851601,6502723,6348878
"2017","경기도","15~19세",741283,383053,358230
"2017","경기도","20~24세",849008,452960,396048
"2017","경기도","25~29세",876704,470526,406178
"2017","경기도","30~34세",906282,477664,428618
"2017","경기도","35~39세",1101844,568303,533541
"2017","경기도","40~44세",1097795,560690,537105
"2017","경기도","45~49세",1204113,610206,593907
"2017","경기도","50~54세",1055583,537785,517798
"2017","경기도","55~59세",1015993,516234,499759
"2017","경기도","60~64세",716151,357073,359078
"2017","경기도","15세미만",1841134,945563,895571
"2017","경기도","65세이상",1445711,622666,823045
"2017","강원특별자치도","합계",1521386,769043,752343
"2017","강원특별자치도","15~19세",89850,47915,41935
"2017","강원특별자치도","20~24세",107260,61508,45752
"2017","강원특별자치도","25~29세",84879,48381,36498
"2017","강원특별자치도","30~34세",79689,42731,36958
"2017","강원특별자치도","35~39세",98679,50391,48288
"2017","강원특별자치도","40~44세",108105,55547,52558
"2017","강원특별자치도","45~49세",125915,65585,60330
"2017","강원특별자치도","50~54세",121263,62397,58866
"2017","강원특별자치도","55~59세",140558,70338,70220
"2017","강원특별자치도","60~64세",112039,56432,55607
"2017","강원특별자치도","15세미만",181656,93643,88013
"2017","강원특별자치도","65세이상",271493,114175,157318
"2017","충청북도","합계",1611009,818500,792509
"2017","충청북도","15~19세",96815,50954,45861
"2017","충청북도","20~24세",118717,65217,53500
"2017","충청북도","25~29세",99523,56215,43308
"2017","충청북도","30~34세",100098,54074,46024
"2017","충청북도","35~39세",116122,61092,55030
"2017","충청북도","40~44세",119249,61810,57439
"2017","충청북도","45~49세",135000,69526,65474
"2017","충청북도","50~54세",126496,65359,61137
"2017","충청북도","55~59세",137450,70034,67416
"2017","충청북도","60~64세",106038,53233,52805
"2017","충청북도","15세미만",208473,107355,101118
"2017","충청북도","65세이상",247028,103631,143397
"2017","충청남도","합계",2162426,1108610,1053816
"2017","충청남도","15~19세",128419,67255,61164
"2017","충청남도","20~24세",148933,79921,69012
"2017","충청남도","25~29세",132844,75318,57526
"2017","충청남도","30~34세",142897,79028,63869
"2017","충청남도","35~39세",167736,91369,76367
"2017","충청남도","40~44세",162681,86985,75696
"2017","충청남도","45~49세",175351,93668,81683
"2017","충청남도","50~54세",158122,83518,74604
"2017","충청남도","55~59세",169336,86830,82506
"2017","충청남도","60~64세",130826,65553,65273
"2017","충청남도","15세미만",291263,150034,141229
"2017","충청남도","65세이상",354018,149131,204887
"2017","전라북도","합계",1826174,911592,914582
"2017","전라북도","15~19세",114829,60874,53955
"2017","전라북도","20~24세",128067,70721,57346
"2017","전라북도","25~29세",99015,53533,45482
"2017","전라북도","30~34세",97034,50645,46389
"2017","전라북도","35~39세",120108,62003,58105
"2017","전라북도","40~44세",131711,67634,64077
"2017","전라북도","45~49세",150192,77962,72230
"2017","전라북도","50~54세",140178,72239,67939
"2017","전라북도","55~59세",150771,75531,75240
"2017","전라북도","60~64세",120983,60096,60887
"2017","전라북도","15세미만",231365,119363,112002
"2017","전라북도","65세이상",341921,140991,200930
"2017","전라남도","합계",1792319,899077,893242
"2017","전라남도","15~19세",101276,54087,47189
"2017","전라남도","20~24세",99316,58188,41128
"2017","전라남도","25~29세",85448,46344,39104
"2017","전라남도","30~34세",92737,48937,43800
"2017","전라남도","35~39세",116128,61550,54578
"2017","전라남도","40~44세",122230,64817,57413
"2017","전라남도","45~49세",144949,77420,67529
"2017","전라남도","50~54세",143640,76408,67232
"2017","전라남도","55~59세",153229,78047,75182
"2017","전라남도","60~64세",119939,60069,59870
"2017","전라남도","15세미만",225914,116096,109818
"2017","전라남도","65세이상",387513,157114,230399
"2017","경상북도","합계",2677058,1353083,1323975
"2017","경상북도","15~19세",149154,80243,68911
"2017","경상북도","20~24세",171472,97456,74016
"2017","경상북도","25~29세",148590,85124,63466
"2017","경상북도","30~34세",154975,84419,70556
"2017","경상북도","35~39세",184749,97919,86830
"2017","경상북도","40~44세",188431,98030,90401
"2017","경상북도","45~49세",217952,113552,104400
"2017","경상북도","50~54세",213011,109670,103341
"2017","경상북도","55~59세",235410,118798,116612
"2017","경상북도","60~64세",192462,95484,96978
"2017","경상북도","15세미만",322028,167421,154607
"2017","경상북도","65세이상",498824,204967,293857
"2017","경상남도","합계",3345293,1702150,1643143
"2017","경상남도","15~19세",187833,100527,87306
"2017","경상남도","20~24세",200573,115751,84822
"2017","경상남도","25~29세",190998,107683,83315
"2017","경상남도","30~34세",211996,116345,95651
"2017","경상남도","35~39세",264841,140405,124436
"2017","경상남도","40~44세",263101,136577,126524
"2017","경상남도","45~49세",298226,153413,144813
"2017","경상남도","50~54세",271244,139171,132073
"2017","경상남도","55~59세",286687,144897,141790
"2017","경상남도","60~64세",217121,108098,109023
"2017","경상남도","15세미만",462199,239298,222901
"2017","경상남도","65세이상",490474,199985,290489
"2017","제주특별자치도","합계",641757,324015,317742
"2017","제주특별자치도","15~19세",37604,19729,17875
"2017","제주특별자치도","20~24세",40351,22127,18224
"2017","제주특별자치도","25~29세",37087,19702,17385
"2017","제주특별자치도","30~34세",39400,20401,18999
"2017","제주특별자치도","35~39세",50475,25838,24637
"2017","제주특별자치도","40~44세",52454,27370,25084
"2017","제주특별자치도","45~49세",58762,30640,28122
"2017","제주특별자치도","50~54세",51683,26967,24716
"2017","제주특별자치도","55~59세",48614,24800,23814
"2017","제주특별자치도","60~64세",37152,18463,18689
"2017","제주특별자치도","15세미만",97748,50708,47040
"2017","제주특별자치도","65세이상",90427,37270,53157
"2018","전국","합계",51629512,25877195,25752317
"2018","전국","15~19세",2772966,1445280,1327686
"2018","전국","20~24세",3484744,1851798,1632946
"2018","전국","25~29세",3520222,1884327,1635895
"2018","전국","30~34세",3339755,1755850,1583905
"2018","전국","35~39세",4106922,2120795,1986127
"2018","전국","40~44세",3910064,2001842,1908222
"2018","전국","45~49세",4498819,2282577,2216242
"2018","전국","50~54세",4196221,2109486,2086735
"2018","전국","55~59세",4319504,2154401,2165103
"2018","전국","60~64세",3482338,1715950,1766388
"2018","전국","15세미만",6542808,3366547,3176261
"2018","전국","65세이상",7455149,3188342,4266807
"2018","서울특별시","합계",9673936,4718972,4954964
"2018","서울특별시","15~19세",465785,235494,230291
"2018","서울특별시","20~24세",691954,330203,361751
"2018","서울특별시","25~29세",799023,395630,403393
"2018","서울특별시","30~34세",738359,369944,368415
"2018","서울특별시","35~39세",804461,407004,397457
"2018","서울특별시","40~44세",720732,360945,359787
"2018","서울특별시","45~49세",835977,414897,421080
"2018","서울특별시","50~54세",757187,370282,386905
"2018","서울특별시","55~59세",786431,378116,408315
"2018","서울특별시","60~64세",673923,320123,353800
"2018","서울특별시","15세미만",1043629,536422,507207
"2018","서울특별시","65세이상",1356475,599912,756563
"2018","부산광역시","합계",3395278,1668984,1726294
"2018","부산광역시","15~19세",170236,88659,81577
"2018","부산광역시","20~24세",234572,123137,111435
"2018","부산광역시","25~29세",223464,118685,104779
"2018","부산광역시","30~34세",197580,102511,95069
"2018","부산광역시","35~39세",253798,130059,123739
"2018","부산광역시","40~44세",236317,120333,115984
"2018","부산광역시","45~49세",276778,137022,139756
"2018","부산광역시","50~54세",269069,129854,139215
"2018","부산광역시","55~59세",308391,146553,161838
"2018","부산광역시","60~64세",276347,131953,144394
"2018","부산광역시","15세미만",374931,192892,182039
"2018","부산광역시","65세이상",573795,247326,326469
"2018","대구광역시","합계",2444412,1212777,1231635
"2018","대구광역시","15~19세",138818,73362,65456
"2018","대구광역시","20~24세",171337,92437,78900
"2018","대구광역시","25~29세",160410,87897,72513
"2018","대구광역시","30~34세",140352,74752,65600
"2018","대구광역시","35~39세",180401,90566,89835
"2018","대구광역시","40~44세",181974,90588,91386
"2018","대구광역시","45~49세",218536,107037,111499
"2018","대구광역시","50~54세",211168,103557,107611
"2018","대구광역시","55~59세",215213,105143,110070
"2018","대구광역시","60~64세",166957,81276,85681
"2018","대구광역시","15세미만",301593,155498,146095
"2018","대구광역시","65세이상",357653,150664,206989
"2018","인천광역시","합계",2936117,1476097,1460020
"2018","인천광역시","15~19세",154377,79492,74885
"2018","인천광역시","20~24세",191027,100888,90139
"2018","인천광역시","25~29세",211776,111540,100236
"2018","인천광역시","30~34세",197752,103992,93760
"2018","인천광역시","35~39세",246585,128284,118301
"2018","인천광역시","40~44세",229935,118706,111229
"2018","인천광역시","45~49세",261999,131828,130171
"2018","인천광역시","50~54세",250929,124114,126815
"2018","인천광역시","55~59세",258924,130359,128565
"2018","인천광역시","60~64세",192973,96094,96879
"2018","인천광역시","15세미만",383403,196817,186586
"2018","인천광역시","65세이상",356437,153983,202454
"2018","광주광역시","합계",1490092,741728,748364
"2018","광주광역시","15~19세",95991,49482,46509
"2018","광주광역시","20~24세",118636,61702,56934
"2018","광주광역시","25~29세",100269,52939,47330
"2018","광주광역시","30~34세",89671,46229,43442
"2018","광주광역시","35~39세",117599,59291,58308
"2018","광주광역시","40~44세",117521,59064,58457
"2018","광주광역시","45~49세",133365,66705,66660
"2018","광주광역시","50~54세",121016,60588,60428
"2018","광주광역시","55~59세",115081,57147,57934
"2018","광주광역시","60~64세",85764,41772,43992
"2018","광주광역시","15세미만",206557,106687,99870
"2018","광주광역시","65세이상",188622,80122,108500
"2018","대전광역시","합계",1511214,758035,753179
"2018","대전광역시","15~19세",95355,49889,45466
"2018","대전광역시","20~24세",127118,67257,59861
"2018","대전광역시","25~29세",109138,59465,49673
"2018","대전광역시","30~34세",95251,49924,45327
"2018","대전광역시","35~39세",115195,58223,56972
"2018","대전광역시","40~44세",114245,56910,57335
"2018","대전광역시","45~49세",132763,66216,66547
"2018","대전광역시","50~54세",119473,59413,60060
"2018","대전광역시","55~59세",120602,59583,61019
"2018","대전광역시","60~64세",95516,47003,48513
"2018","대전광역시","15세미만",199342,102813,96529
"2018","대전광역시","65세이상",187216,81339,105877
"2018","울산광역시","합계",1150116,595795,554321
"2018","울산광역시","15~19세",63055,34433,28622
"2018","울산광역시","20~24세",73066,42595,30471
"2018","울산광역시","25~29세",76961,43594,33367
"2018","울산광역시","30~34세",74711,40707,34004
"2018","울산광역시","35~39세",96923,50903,46020
"2018","울산광역시","40~44세",89675,46287,43388
"2018","울산광역시","45~49세",105641,52547,53094
"2018","울산광역시","50~54세",106434,54185,52249
"2018","울산광역시","55~59세",103394,53366,50028
"2018","울산광역시","60~64세",75971,38500,37471
"2018","울산광역시","15세미만",162859,84485,78374
"2018","울산광역시","65세이상",121426,54193,67233
"2018","세종특별자치시","합계",312374,157289,155085
"2018","세종특별자치시","15~19세",17348,8818,8530
"2018","세종특별자치시","20~24세",19692,10629,9063
"2018","세종특별자치시","25~29세",18783,9804,8979
"2018","세종특별자치시","30~34세",23853,11766,12087
"2018","세종특별자치시","35~39세",33736,16443,17293
"2018","세종특별자치시","40~44세",30228,15349,14879
"2018","세종특별자치시","45~49세",26319,14220,12099
"2018","세종특별자치시","50~54세",19174,9962,9212
"2018","세종특별자치시","55~59세",18027,9172,8855
"2018","세종특별자치시","60~64세",14202,7068,7134
"2018","세종특별자치시","15세미만",63161,32078,31083
"2018","세종특별자치시","65세이상",27851,11980,15871
"2018","경기도","합계",13103188,6635106,6468082
"2018","경기도","15~19세",711806,367865,343941
"2018","경기도","20~24세",847682,452265,395417
"2018","경기도","25~29세",919599,496998,422601
"2018","경기도","30~34세",899207,476558,422649
"2018","경기도","35~39세",1131739,585920,545819
"2018","경기도","40~44세",1079663,553658,526005
"2018","경기도","45~49세",1214041,616974,597067
"2018","경기도","50~54세",1091113,551060,540053
"2018","경기도","55~59세",1056744,536539,520205
"2018","경기도","60~64세",789566,394929,394637
"2018","경기도","15세미만",1832157,939821,892336
"2018","경기도","65세이상",1529871,662519,867352
"2018","강원특별자치도","합계",1520391,768604,751787
"2018","강원특별자치도","15~19세",85220,45359,39861
"2018","강원특별자치도","20~24세",105492,60397,45095
"2018","강원특별자치도","25~29세",86744,49825,36919
"2018","강원특별자치도","30~34세",76859,41343,35516
"2018","강원특별자치도","35~39세",98178,50306,47872
"2018","강원특별자치도","40~44세",103412,52901,50511
"2018","강원특별자치도","45~49세",123948,64550,59398
"2018","강원특별자치도","50~54세",122446,63047,59399
"2018","강원특별자치도","55~59세",139915,70108,69807
"2018","강원특별자치도","60~64세",121823,61442,60381
"2018","강원특별자치도","15세미만",176318,90765,85553
"2018","강원특별자치도","65세이상",280036,118561,161475
"2018","충청북도","합계",1620935,826183,794752
"2018","충청북도","15~19세",91800,48510,43290
"2018","충청북도","20~24세",117659,65165,52494
"2018","충청북도","25~29세",103505,59358,44147
"2018","충청북도","30~34세",97768,53421,44347
"2018","충청북도","35~39세",117850,62202,55648
"2018","충청북도","40~44세",115493,60046,55447
"2018","충청북도","45~49세",133310,68972,64338
"2018","충청북도","50~54세",130773,67034,63739
"2018","충청북도","55~59세",137525,70114,67411
"2018","충청북도","60~64세",115153,58123,57030
"2018","충청북도","15세미만",204391,105072,99319
"2018","충청북도","65세이상",255708,108166,147542
"2018","충청남도","합계",2181416,1119996,1061420
"2018","충청남도","15~19세",123026,64278,58748
"2018","충청남도","20~24세",148850,80883,67967
"2018","충청남도","25~29세",135158,76756,58402
"2018","충청남도","30~34세",139708,77443,62265
"2018","충청남도","35~39세",171232,93064,78168
"2018","충청남도","40~44세",160037,86036,74001
"2018","충청남도","45~49세",175970,94315,81655
"2018","충청남도","50~54세",163316,85911,77405
"2018","충청남도","55~59세",172275,88802,83473
"2018","충청남도","60~64세",141028,70769,70259
"2018","충청남도","15세미만",287660,147958,139702
"2018","충청남도","65세이상",363156,153781,209375
"2018","전라북도","합계",1818157,907683,910474
"2018","전라북도","15~19세",108439,57444,50995
"2018","전라북도","20~24세",128024,71071,56953
"2018","전라북도","25~29세",100946,54850,46096
"2018","전라북도","30~34세",92655,48275,44380
"2018","전라북도","35~39세",118600,61118,57482
"2018","전라북도","40~44세",125991,64585,61406
"2018","전라북도","45~49세",148594,76927,71667
"2018","전라북도","50~54세",142504,73368,69136
"2018","전라북도","55~59세",152161,76491,75670
"2018","전라북도","60~64세",128339,63900,64439
"2018","전라북도","15세미만",223458,115243,108215
"2018","전라북도","65세이상",348446,144411,204035
"2018","전라남도","합계",1790352,900154,890198
"2018","전라남도","15~19세",95929,51413,44516
"2018","전라남도","20~24세",100089,58859,41230
"2018","전라남도","25~29세",89241,49052,40189
"2018","전라남도","30~34세",87812,46449,41363
"2018","전라남도","35~39세",116372,61577,54795
"2018","전라남도","40~44세",117596,62349,55247
"2018","전라남도","45~49세",142245,75738,66507
"2018","전라남도","50~54세",145188,77326,67862
"2018","전라남도","55~59세",155654,79688,75966
"2018","전라남도","60~64세",129201,65233,63968
"2018","전라남도","15세미만",219431,112641,106790
"2018","전라남도","65세이상",391594,159829,231765
"2018","경상북도","합계",2672902,1352869,1320033
"2018","경상북도","15~19세",141480,76179,65301
"2018","경상북도","20~24세",169986,96945,73041
"2018","경상북도","25~29세",149950,86382,63568
"2018","경상북도","30~34세",147935,81434,66501
"2018","경상북도","35~39세",185527,98199,87328
"2018","경상북도","40~44세",181216,94755,86461
"2018","경상북도","45~49세",213609,111118,102491
"2018","경상북도","50~54세",215833,110928,104905
"2018","경상북도","55~59세",238106,120370,117736
"2018","경상북도","60~64세",201152,100428,100724
"2018","경상북도","15세미만",313639,162926,150713
"2018","경상북도","65세이상",514469,213205,301264
"2018","경상남도","합계",3350350,1703904,1646446
"2018","경상남도","15~19세",177600,95305,82295
"2018","경상남도","20~24세",198855,114850,84005
"2018","경상남도","25~29세",194467,109699,84768
"2018","경상남도","30~34세",201095,110616,90479
"2018","경상남도","35~39세",265736,140598,125138
"2018","경상남도","40~44세",254207,132335,121872
"2018","경상남도","45~49세",295793,152356,143437
"2018","경상남도","50~54세",277459,141065,136394
"2018","경상남도","55~59세",290088,146891,143197
"2018","경상남도","60~64세",233714,116896,116818
"2018","경상남도","15세미만",452388,233745,218643
"2018","경상남도","65세이상",508948,209548,299400
"2018","제주특별자치도","합계",658282,333019,325263
"2018","제주특별자치도","15~19세",36701,19298,17403
"2018","제주특별자치도","20~24세",40705,22515,18190
"2018","제주특별자치도","25~29세",40788,21853,18935
"2018","제주특별자치도","30~34세",39187,20486,18701
"2018","제주특별자치도","35~39세",52990,27038,25952
"2018","제주특별자치도","40~44세",51822,26995,24827
"2018","제주특별자치도","45~49세",59931,31155,28776
"2018","제주특별자치도","50~54세",53139,27792,25347
"2018","제주특별자치도","55~59세",50973,25959,25014
"2018","제주특별자치도","60~64세",40709,20441,20268
"2018","제주특별자치도","15세미만",97891,50684,47207
"2018","제주특별자치도","65세이상",93446,38803,54643
"2019","전국","합계",51779203,25952070,25827133
"2019","전국","15~19세",2637341,1371661,1265680
"2019","전국","20~24세",3413656,1806316,1607340
"2019","전국","25~29세",3612505,1938641,1673864
"2019","전국","30~34세",3304679,1745076,1559603
"2019","전국","35~39세",3999744,2070152,1929592
"2019","전국","40~44세",3855403,1974200,1881203
"2019","전국","45~49세",4449226,2263200,2186026
"2019","전국","50~54세",4322368,2170535,2151833
"2019","전국","55~59세",4285702,2143941,2141761
"2019","전국","60~64세",3689408,1816973,1872435
"2019","전국","15세미만",6392180,3286624,3105556
"2019","전국","65세이상",7816991,3364751,4452240
"2019","서울특별시","합계",9639541,4690440,4949101
"2019","서울특별시","15~19세",443224,222941,220283
"2019","서울특별시","20~24세",681005,319500,361505
"2019","서울특별시","25~29세",821238,405143,416095
"2019","서울특별시","30~34세",729069,364799,364270
"2019","서울특별시","35~39세",778838,393596,385242
"2019","서울특별시","40~44세",705535,352718,352817
"2019","서울특별시","45~49세",817450,406212,411238
"2019","서울특별시","50~54세",769856,376654,393202
"2019","서울특별시","55~59세",769236,371525,397711
"2019","서울특별시","60~64세",697227,330631,366596
"2019","서울특별시","15세미만",1006916,517881,489035
"2019","서울특별시","65세이상",1419947,628840,791107
"2019","부산광역시","합계",3372692,1655566,1717126
"2019","부산광역시","15~19세",159525,82794,76731
"2019","부산광역시","20~24세",226140,118208,107932
"2019","부산광역시","25~29세",225555,119893,105662
"2019","부산광역시","30~34세",192974,100218,92756
"2019","부산광역시","35~39세",242964,124675,118289
"2019","부산광역시","40~44세",232814,118424,114390
"2019","부산광역시","45~49세",270887,134865,136022
"2019","부산광역시","50~54세",272717,131636,141081
"2019","부산광역시","55~59세",296549,141227,155322
"2019","부산광역시","60~64세",285494,135149,150345
"2019","부산광역시","15세미만",364354,187231,177123
"2019","부산광역시","65세이상",602719,261246,341473
"2019","대구광역시","합계",2429940,1203754,1226186
"2019","대구광역시","15~19세",131202,69196,62006
"2019","대구광역시","20~24세",167561,89812,77749
"2019","대구광역시","25~29세",161994,88259,73735
"2019","대구광역시","30~34세",138781,74498,64283
"2019","대구광역시","35~39세",172733,87192,85541
"2019","대구광역시","40~44세",175876,87458,88418
"2019","대구광역시","45~49세",213400,104788,108612
"2019","대구광역시","50~54세",214280,104751,109529
"2019","대구광역시","55~59세",211437,103324,108113
"2019","대구광역시","60~64세",177148,85958,91190
"2019","대구광역시","15세미만",292063,150477,141586
"2019","대구광역시","65세이상",373465,158041,215424
"2019","인천광역시","합계",2952237,1484528,1467709
"2019","인천광역시","15~19세",148004,76109,71895
"2019","인천광역시","20~24세",187191,98715,88476
"2019","인천광역시","25~29세",217524,115323,102201
"2019","인천광역시","30~34세",195774,103261,92513
"2019","인천광역시","35~39세",239555,124551,115004
"2019","인천광역시","40~44세",228183,117893,110290
"2019","인천광역시","45~49세",258677,131290,127387
"2019","인천광역시","50~54세",256421,126446,129975
"2019","인천광역시","55~59세",258996,130128,128868
"2019","인천광역시","60~64세",208358,103782,104576
"2019","인천광역시","15세미만",375224,192662,182562
"2019","인천광역시","65세이상",378330,164368,213962
"2019","광주광역시","합계",1489730,741287,748443
"2019","광주광역시","15~19세",90702,46731,43971
"2019","광주광역시","20~24세",117694,60731,56963
"2019","광주광역시","25~29세",104600,55536,49064
"2019","광주광역시","30~34세",87174,45097,42077
"2019","광주광역시","35~39세",113361,57516,55845
"2019","광주광역시","40~44세",114858,57481,57377
"2019","광주광역시","45~49세",133073,66538,66535
"2019","광주광역시","50~54세",124598,62354,62244
"2019","광주광역시","55~59세",114111,56861,57250
"2019","광주광역시","60~64세",92620,45158,47462
"2019","광주광역시","15세미만",200619,103487,97132
"2019","광주광역시","65세이상",196320,83797,112523
"2019","대전광역시","합계",1498839,751585,747254
"2019","대전광역시","15~19세",90628,47490,43138
"2019","대전광역시","20~24세",124362,65124,59238
"2019","대전광역시","25~29세",111165,60580,50585
"2019","대전광역시","30~34세",92983,49344,43639
"2019","대전광역시","35~39세",110133,55973,54160
"2019","대전광역시","40~44세",110297,54900,55397
"2019","대전광역시","45~49세",129472,64766,64706
"2019","대전광역시","50~54세",123737,61470,62267
"2019","대전광역시","55~59세",118422,58710,59712
"2019","대전광역시","60~64세",100048,49170,50878
"2019","대전광역시","15세미만",190706,98212,92494
"2019","대전광역시","65세이상",196886,85846,111040
"2019","울산광역시","합계",1143692,591965,551727
"2019","울산광역시","15~19세",58614,31852,26762
"2019","울산광역시","20~24세",70145,40951,29194
"2019","울산광역시","25~29세",76543,43548,32995
"2019","울산광역시","30~34세",72465,39810,32655
"2019","울산광역시","35~39세",93355,49032,44323
"2019","울산광역시","40~44세",88494,46001,42493
"2019","울산광역시","45~49세",102387,50955,51432
"2019","울산광역시","50~54세",108271,54637,53634
"2019","울산광역시","55~59세",103128,53237,49891
"2019","울산광역시","60~64세",81602,41273,40329
"2019","울산광역시","15세미만",158703,82145,76558
"2019","울산광역시","65세이상",129985,58524,71461
"2019","세종특별자치시","합계",338136,170148,167988
"2019","세종특별자치시","15~19세",17841,8968,8873
"2019","세종특별자치시","20~24세",20804,11216,9588
"2019","세종특별자치시","25~29세",20867,10901,9966
"2019","세종특별자치시","30~34세",25627,12677,12950
"2019","세종특별자치시","35~39세",35451,17382,18069
"2019","세종특별자치시","40~44세",32778,16485,16293
"2019","세종특별자치시","45~49세",29517,15700,13817
"2019","세종특별자치시","50~54세",22016,11488,10528
"2019","세종특별자치시","55~59세",19389,9897,9492
"2019","세종특별자치시","60~64세",16003,7992,8011
"2019","세종특별자치시","15세미만",67563,34294,33269
"2019","세종특별자치시","65세이상",30280,13148,17132
"2019","경기도","합계",13300900,6740448,6560452
"2019","경기도","15~19세",684717,353116,331601
"2019","경기도","20~24세",834387,444948,389439
"2019","경기도","25~29세",953622,517879,435743
"2019","경기도","30~34세",906611,483344,423267
"2019","경기도","35~39세",1118336,582039,536297
"2019","경기도","40~44세",1079145,554175,524970
"2019","경기도","45~49세",1214187,619038,595149
"2019","경기도","50~54세",1138512,572780,565732
"2019","경기도","55~59세",1073487,544882,528605
"2019","경기도","60~64세",856522,428906,427616
"2019","경기도","15세미만",1811514,928861,882653
"2019","경기도","65세이상",1629860,710480,919380
"2019","강원특별자치도","합계",1520127,767717,752410
"2019","강원특별자치도","15~19세",79998,42385,37613
"2019","강원특별자치도","20~24세",102735,58406,44329
"2019","강원특별자치도","25~29세",87962,50362,37600
"2019","강원특별자치도","30~34세",76364,41162,35202
"2019","강원특별자치도","35~39세",95332,49118,46214
"2019","강원특별자치도","40~44세",99749,50936,48813
"2019","강원특별자치도","45~49세",122187,63420,58767
"2019","강원특별자치도","50~54세",125605,64518,61087
"2019","강원특별자치도","55~59세",137387,69326,68061
"2019","강원특별자치도","60~64세",128720,64683,64037
"2019","강원특별자치도","15세미만",171615,88287,83328
"2019","강원특별자치도","65세이상",292473,125114,167359
"2019","충청북도","합계",1629343,832543,796800
"2019","충청북도","15~19세",87200,46116,41084
"2019","충청북도","20~24세",115325,64204,51121
"2019","충청북도","25~29세",107289,62250,45039
"2019","충청북도","30~34세",96888,53193,43695
"2019","충청북도","35~39세",115928,61457,54471
"2019","충청북도","40~44세",113640,59283,54357
"2019","충청북도","45~49세",130855,67998,62857
"2019","충청북도","50~54세",137475,70336,67139
"2019","충청북도","55~59세",135596,69416,66180
"2019","충청북도","60~64세",121813,61505,60308
"2019","충청북도","15세미만",200180,102758,97422
"2019","충청북도","65세이상",267154,114027,153127
"2019","충청남도","합계",2188649,1124678,1063971
"2019","충청남도","15~19세",118253,61663,56590
"2019","충청남도","20~24세",146308,79091,67217
"2019","충청남도","25~29세",136534,78016,58518
"2019","충청남도","30~34세",137629,76834,60795
"2019","충청남도","35~39세",167421,90855,76566
"2019","충청남도","40~44세",158686,85226,73460
"2019","충청남도","45~49세",175448,94308,81140
"2019","충청남도","50~54세",169756,89458,80298
"2019","충청남도","55~59세",172052,89402,82650
"2019","충청남도","60~64세",148630,74683,73947
"2019","충청남도","15세미만",281398,144716,136682
"2019","충청남도","65세이상",376534,160426,216108
"2019","전라북도","합계",1807423,902704,904719
"2019","전라북도","15~19세",101942,53956,47986
"2019","전라북도","20~24세",124548,69242,55306
"2019","전라북도","25~29세",103749,56701,47048
"2019","전라북도","30~34세",89313,46712,42601
"2019","전라북도","35~39세",114218,58694,55524
"2019","전라북도","40~44세",120833,61886,58947
"2019","전라북도","45~49세",147802,76470,71332
"2019","전라북도","50~54세",146460,75420,71040
"2019","전라북도","55~59세",149653,75865,73788
"2019","전라북도","60~64세",133798,66591,67207
"2019","전라북도","15세미만",215417,110972,104445
"2019","전라북도","65세이상",359690,150195,209495
"2019","전라남도","합계",1787543,901813,885730
"2019","전라남도","15~19세",89719,48107,41612
"2019","전라남도","20~24세",98558,58143,40415
"2019","전라남도","25~29세",93860,52690,41170
"2019","전라남도","30~34세",85624,45848,39776
"2019","전라남도","35~39세",112547,59756,52791
"2019","전라남도","40~44세",115357,61069,54288
"2019","전라남도","45~49세",140542,75064,65478
"2019","전라남도","50~54세",147736,78917,68819
"2019","전라남도","55~59세",153304,79092,74212
"2019","전라남도","60~64세",137983,69758,68225
"2019","전라남도","15세미만",212598,108854,103744
"2019","전라남도","65세이상",399715,164515,235200
"2019","경상북도","합계",2668154,1352404,1315750
"2019","경상북도","15~19세",133650,71926,61724
"2019","경상북도","20~24세",164796,94430,70366
"2019","경상북도","25~29세",151259,87349,63910
"2019","경상북도","30~34세",143954,80198,63756
"2019","경상북도","35~39세",180096,95456,84640
"2019","경상북도","40~44세",176851,92763,84088
"2019","경상북도","45~49세",210989,109796,101193
"2019","경상북도","50~54세",220540,113525,107015
"2019","경상북도","55~59세",234911,119566,115345
"2019","경상북도","60~64세",211954,105889,106065
"2019","경상북도","15세미만",305576,158353,147223
"2019","경상북도","65세이상",533578,223153,310425
"2019","경상남도","합계",3347209,1703892,1643317
"2019","경상남도","15~19세",167002,89778,77224
"2019","경상남도","20~24세",192416,111647,80769
"2019","경상남도","25~29세",196129,111070,85059
"2019","경상남도","30~34세",194809,107879,86930
"2019","경상남도","35~39세",257405,136227,121178
"2019","경상남도","40~44세",250743,130884,119859
"2019","경상남도","45~49세",291703,150515,141188
"2019","경상남도","50~54세",289172,147229,141943
"2019","경상남도","55~59세",286323,145052,141271
"2019","경상남도","60~64세",248003,124073,123930
"2019","경상남도","15세미만",440919,227408,213511
"2019","경상남도","65세이상",532585,222130,310455
"2019","제주특별자치도","합계",665048,336598,328450
"2019","제주특별자치도","15~19세",35120,18533,16587
"2019","제주특별자치도","20~24세",39681,21948,17733
"2019","제주특별자치도","25~29세",42615,23141,19474
"2019","제주특별자치도","30~34세",38640,20202,18438
"2019","제주특별자치도","35~39세",52071,26633,25438
"2019","제주특별자치도","40~44세",51564,26618,24946
"2019","제주특별자치도","45~49세",60650,31477,29173
"2019","제주특별자치도","50~54세",55216,28916,26300
"2019","제주특별자치도","55~59세",51721,26431,25290
"2019","제주특별자치도","60~64세",43485,21772,21713
"2019","제주특별자치도","15세미만",96815,50026,46789
"2019","제주특별자치도","65세이상",97470,40901,56569
"2020","전국","합계",51829136,25915207,25913929
"2020","전국","15~19세",2449561,1271404,1178157
"2020","전국","20~24세",3364804,1762135,1602669
"2020","전국","25~29세",3666212,1959723,1706489
"2020","전국","30~34세",3301331,1742483,1558848
"2020","전국","35~39세",3805470,1970249,1835221
"2020","전국","40~44세",3906665,1997630,1909035
"2020","전국","45~49세",4325697,2196042,2129655
"2020","전국","50~54세",4372054,2195060,2176994
"2020","전국","55~59세",4210645,2109380,2101265
"2020","전국","60~64세",3885297,1912792,1972505
"2020","전국","15세미만",6254157,3213380,3040777
"2020","전국","65세이상",8287243,3584929,4702314
"2020","서울특별시","합계",9586195,4647733,4938462
"2020","서울특별시","15~19세",408748,206091,202657
"2020","서울특별시","20~24세",664188,308209,355979
"2020","서울특별시","25~29세",835286,406953,428333
"2020","서울특별시","30~34세",734952,367172,367780
"2020","서울특별시","35~39세",745117,375820,369297
"2020","서울특별시","40~44세",709736,353683,356053
"2020","서울특별시","45~49세",783563,388580,394983
"2020","서울특별시","50~54세",773582,378429,395153
"2020","서울특별시","55~59세",743817,360318,383499
"2020","서울특별시","60~64세",712641,337235,375406
"2020","서울특별시","15세미만",975117,501240,473877
"2020","서울특별시","65세이상",1499448,664003,835445
"2020","부산광역시","합계",3349016,1638751,1710265
"2020","부산광역시","15~19세",144199,74893,69306
"2020","부산광역시","20~24세",218047,112542,105505
"2020","부산광역시","25~29세",226843,119788,107055
"2020","부산광역시","30~34세",192718,100029,92689
"2020","부산광역시","35~39세",227062,116286,110776
"2020","부산광역시","40~44세",236830,120485,116345
"2020","부산광역시","45~49세",260800,129863,130937
"2020","부산광역시","50~54세",273734,132689,141045
"2020","부산광역시","55~59세",281623,134264,147359
"2020","부산광역시","60~64세",291543,137595,153948
"2020","부산광역시","15세미만",356727,183161,173566
"2020","부산광역시","65세이상",638890,277156,361734
"2020","대구광역시","합계",2410700,1190271,1220429
"2020","대구광역시","15~19세",120738,63343,57395
"2020","대구광역시","20~24세",164883,87519,77364
"2020","대구광역시","25~29세",163122,88145,74977
"2020","대구광역시","30~34세",138022,74266,63756
"2020","대구광역시","35~39세",160788,81511,79277
"2020","대구광역시","40~44세",175075,87078,87997
"2020","대구광역시","45~49세",204666,100187,104479
"2020","대구광역시","50~54세",214621,104875,109746
"2020","대구광역시","55~59세",206714,100742,105972
"2020","대구광역시","60~64세",185094,89740,95354
"2020","대구광역시","15세미만",282698,145454,137244
"2020","대구광역시","65세이상",394279,167411,226868
"2020","인천광역시","합계",2945454,1477064,1468390
"2020","인천광역시","15~19세",137257,70521,66736
"2020","인천광역시","20~24세",183896,95592,88304
"2020","인천광역시","25~29세",218574,115347,103227
"2020","인천광역시","30~34세",194775,102684,92091
"2020","인천광역시","35~39세",225743,117514,108229
"2020","인천광역시","40~44세",230990,119057,111933
"2020","인천광역시","45~49세",251386,127783,123603
"2020","인천광역시","50~54세",255672,126290,129382
"2020","인천광역시","55~59세",255044,127389,127655
"2020","인천광역시","60~64세",222461,110882,111579
"2020","인천광역시","15세미만",364061,186944,177117
"2020","인천광역시","65세이상",405595,177061,228534
"2020","광주광역시","합계",1477573,734140,743433
"2020","광주광역시","15~19세",81777,42398,39379
"2020","광주광역시","20~24세",113852,59055,54797
"2020","광주광역시","25~29세",106966,56242,50724
"2020","광주광역시","30~34세",86109,44639,41470
"2020","광주광역시","35~39세",106220,54072,52148
"2020","광주광역시","40~44세",115100,57375,57725
"2020","광주광역시","45~49세",128960,64319,64641
"2020","광주광역시","50~54세",126078,63089,62989
"2020","광주광역시","55~59세",111673,55684,55989
"2020","광주광역시","60~64세",98575,48116,50459
"2020","광주광역시","15세미만",194754,100309,94445
"2020","광주광역시","65세이상",207509,88842,118667
"2020","대전광역시","합계",1488435,744349,744086
"2020","대전광역시","15~19세",83574,43616,39958
"2020","대전광역시","20~24세",123236,63832,59404
"2020","대전광역시","25~29세",113202,61378,51824
"2020","대전광역시","30~34세",92626,49509,43117
"2020","대전광역시","35~39세",103463,52723,50740
"2020","대전광역시","40~44세",109803,54504,55299
"2020","대전광역시","45~49세",125131,62357,62774
"2020","대전광역시","50~54세",124672,62086,62586
"2020","대전광역시","55~59세",115148,57176,57972
"2020","대전광역시","60~64세",104664,51199,53465
"2020","대전광역시","15세미만",183773,94419,89354
"2020","대전광역시","65세이상",209143,91550,117593
"2020","울산광역시","합계",1135423,585978,549445
"2020","울산광역시","15~19세",54045,29197,24848
"2020","울산광역시","20~24세",67960,39258,28702
"2020","울산광역시","25~29세",75712,42971,32741
"2020","울산광역시","30~34세",70942,39071,31871
"2020","울산광역시","35~39세",86575,45468,41107
"2020","울산광역시","40~44세",90201,46999,43202
"2020","울산광역시","45~49세",98136,48975,49161
"2020","울산광역시","50~54세",107401,53606,53795
"2020","울산광역시","55~59세",102721,53128,49593
"2020","울산광역시","60~64세",86667,43835,42832
"2020","울산광역시","15세미만",154293,79661,74632
"2020","울산광역시","65세이상",140770,63809,76961
"2020","세종특별자치시","합계",353933,177939,175994
"2020","세종특별자치시","15~19세",18999,9479,9520
"2020","세종특별자치시","20~24세",21654,11579,10075
"2020","세종특별자치시","25~29세",21226,11062,10164
"2020","세종특별자치시","30~34세",26074,12939,13135
"2020","세종특별자치시","35~39세",34999,17146,17853
"2020","세종특별자치시","40~44세",35241,17500,17741
"2020","세종특별자치시","45~49세",31435,16567,14868
"2020","세종특별자치시","50~54세",23999,12552,11447
"2020","세종특별자치시","55~59세",20097,10322,9775
"2020","세종특별자치시","60~64세",17376,8657,8719
"2020","세종특별자치시","15세미만",69840,35584,34256
"2020","세종특별자치시","65세이상",32993,14552,18441
"2020","경기도","합계",13511676,6828367,6683309
"2020","경기도","15~19세",654522,335837,318685
"2020","경기도","20~24세",847646,444969,402677
"2020","경기도","25~29세",980796,531660,449136
"2020","경기도","30~34세",919054,489226,429828
"2020","경기도","35~39세",1083739,564534,519205
"2020","경기도","40~44세",1107785,568811,538974
"2020","경기도","45~49세",1195611,608441,587170
"2020","경기도","50~54세",1166575,585288,581287
"2020","경기도","55~59세",1079402,546744,532658
"2020","경기도","60~64세",923711,462472,461239
"2020","경기도","15세미만",1794750,919684,875066
"2020","경기도","65세이상",1758085,770701,987384
"2020","강원특별자치도","합계",1521763,767674,754089
"2020","강원특별자치도","15~19세",72734,38538,34196
"2020","강원특별자치도","20~24세",99186,56128,43058
"2020","강원특별자치도","25~29세",89166,51128,38038
"2020","강원특별자치도","30~34세",76486,41298,35188
"2020","강원특별자치도","35~39세",90838,47094,43744
"2020","강원특별자치도","40~44세",100087,50766,49321
"2020","강원특별자치도","45~49세",118985,61442,57543
"2020","강원특별자치도","50~54세",128191,66334,61857
"2020","강원특별자치도","55~59세",132525,66983,65542
"2020","강원특별자치도","60~64세",136174,68011,68163
"2020","강원특별자치도","15세미만",168414,86491,81923
"2020","강원특별자치도","65세이상",308977,133461,175516
"2020","충청북도","합계",1632088,833819,798269
"2020","충청북도","15~19세",80349,42301,38048
"2020","충청북도","20~24세",112671,62251,50420
"2020","충청북도","25~29세",110612,64492,46120
"2020","충청북도","30~34세",96749,53535,43214
"2020","충청북도","35~39세",111096,58944,52152
"2020","충청북도","40~44세",114380,59730,54650
"2020","충청북도","45~49세",128136,66220,61916
"2020","충청북도","50~54세",137809,70557,67252
"2020","충청북도","55~59세",135185,69535,65650
"2020","충청북도","60~64세",128155,64654,63501
"2020","충청북도","15세미만",195922,100621,95301
"2020","충청북도","65세이상",281024,120979,160045
"2020","충청남도","합계",2176636,1117575,1059061
"2020","충청남도","15~19세",107031,55685,51346
"2020","충청남도","20~24세",138808,74858,63950
"2020","충청남도","25~29세",135452,77631,57821
"2020","충청남도","30~34세",134317,74888,59429
"2020","충청남도","35~39세",158471,86058,72413
"2020","충청남도","40~44세",161373,86684,74689
"2020","충청남도","45~49세",172495,92159,80336
"2020","충청남도","50~54세",170448,89941,80507
"2020","충청남도","55~59세",170461,89158,81303
"2020","충청남도","60~64세",157804,79367,78437
"2020","충청남도","15세미만",274828,141401,133427
"2020","충청남도","65세이상",395148,169745,225403
"2020","전라북도","합계",1802766,899058,903708
"2020","전라북도","15~19세",93811,49481,44330
"2020","전라북도","20~24세",123972,68339,55633
"2020","전라북도","25~29세",105427,57718,47709
"2020","전라북도","30~34세",88247,46489,41758
"2020","전라북도","35~39세",107281,55044,52237
"2020","전라북도","40~44세",120614,61651,58963
"2020","전라북도","45~49세",143786,74113,69673
"2020","전라북도","50~54세",148011,76304,71707
"2020","전라북도","55~59세",145176,74026,71150
"2020","전라북도","60~64세",141250,70209,71041
"2020","전라북도","15세미만",209198,107616,101582
"2020","전라북도","65세이상",375993,158068,217925
"2020","전라남도","합계",1788807,903281,885526
"2020","전라남도","15~19세",82241,44067,38174
"2020","전라남도","20~24세",97640,57331,40309
"2020","전라남도","25~29세",96754,55301,41453
"2020","전라남도","30~34세",84693,45672,39021
"2020","전라남도","35~39세",106686,56818,49868
"2020","전라남도","40~44세",116437,61549,54888
"2020","전라남도","45~49세",136028,72514,63514
"2020","전라남도","50~54세",148786,79427,69359
"2020","전라남도","55~59세",150095,78187,71908
"2020","전라남도","60~64세",146835,74218,72617
"2020","전라남도","15세미만",208760,106884,101876
"2020","전라남도","65세이상",413852,171313,242539
"2020","경상북도","합계",2644757,1338823,1305934
"2020","경상북도","15~19세",120322,64905,55417
"2020","경상북도","20~24세",158436,90539,67897
"2020","경상북도","25~29세",149097,86470,62627
"2020","경상북도","30~34세",139326,77569,61757
"2020","경상북도","35~39세",168255,89176,79079
"2020","경상북도","40~44세",176603,92576,84027
"2020","경상북도","45~49세",204225,106083,98142
"2020","경상북도","50~54세",221464,114100,107364
"2020","경상북도","55~59세",228605,116897,111708
"2020","경상북도","60~64세",224079,112126,111953
"2020","경상북도","15세미만",296691,153642,143049
"2020","경상북도","65세이상",557654,234740,322914
"2020","경상남도","합계",3333056,1692212,1640844
"2020","경상남도","15~19세",155935,83440,72495
"2020","경상남도","20~24세",188811,108384,80427
"2020","경상남도","25~29세",194483,110005,84478
"2020","경상남도","30~34세",187590,103442,84148
"2020","경상남도","35~39세",239226,126641,112585
"2020","경상남도","40~44세",253786,132265,121521
"2020","경상남도","45~49세",282901,145662,137239
"2020","경상남도","50~54세",293790,149729,144061
"2020","경상남도","55~59세",280683,142317,138366
"2020","경상남도","60~64세",262593,131550,131043
"2020","경상남도","15세미만",428355,220840,207515
"2020","경상남도","65세이상",564903,237937,326966
"2020","제주특별자치도","합계",670858,338173,332685
"2020","제주특별자치도","15~19세",33279,17612,15667
"2020","제주특별자치도","20~24세",39918,21750,18168
"2020","제주특별자치도","25~29세",43494,23432,20062
"2020","제주특별자치도","30~34세",38651,20055,18596
"2020","제주특별자치도","35~39세",49911,25400,24511
"2020","제주특별자치도","40~44세",52624,26917,25707
"2020","제주특별자치도","45~49세",59453,30777,28676
"2020","제주특별자치도","50~54세",57221,29764,27457
"2020","제주특별자치도","55~59세",51676,26510,25166
"2020","제주특별자치도","60~64세",45675,22926,22749
"2020","제주특별자치도","15세미만",95976,49429,46547
"2020","제주특별자치도","65세이상",102980,43601,59379
"2021","전국","합계",51738071,25850044,25888027
"2021","전국","15~19세",2313299,1198911,1114388
"2021","전국","20~24세",3223654,1681183,1542471
"2021","전국","25~29세",3663127,1954718,1708409
"2021","전국","30~34세",3332272,1759768,1572504
"2021","전국","35~39세",3622347,1877724,1744623
"2021","전국","40~44세",3981710,2038116,1943594
"2021","전국","45~49세",4134223,2100431,2033792
"2021","전국","50~54세",4477633,2243979,2233654
"2021","전국","55~59세",4097916,2064943,2032973
"2021","전국","60~64세",4097858,2016321,2081537
"2021","전국","15세미만",6087471,3125597,2961874
"2021","전국","65세이상",8706561,3788353,4918208
"2021","서울특별시","합계",9472127,4584251,4887876
"2021","서울특별시","15~19세",382368,192797,189571
"2021","서울특별시","20~24세",638048,293222,344826
"2021","서울특별시","25~29세",832518,402877,429641
"2021","서울특별시","30~34세",736967,367728,369239
"2021","서울특별시","35~39세",706701,355541,351160
"2021","서울특별시","40~44세",714467,356604,357863
"2021","서울특별시","45~49세",736451,365576,370875
"2021","서울특별시","50~54세",789330,385892,403438
"2021","서울특별시","55~59세",712584,348429,364155
"2021","서울특별시","60~64세",725537,343100,382437
"2021","서울특별시","15세미만",932766,479256,453510
"2021","서울특별시","65세이상",1564390,693229,871161
"2021","부산광역시","합계",3324335,1624745,1699590
"2021","부산광역시","15~19세",133751,69252,64499
"2021","부산광역시","20~24세",208829,107261,101568
"2021","부산광역시","25~29세",225547,118753,106794
"2021","부산광역시","30~34세",195096,101304,93792
"2021","부산광역시","35~39세",212116,108897,103219
"2021","부산광역시","40~44세",243155,123791,119364
"2021","부산광역시","45~49세",246880,123585,123295
"2021","부산광역시","50~54세",275962,133756,142206
"2021","부산광역시","55~59세",266432,128220,138212
"2021","부산광역시","60~64세",299182,140499,158683
"2021","부산광역시","15세미만",347277,178205,169072
"2021","부산광역시","65세이상",670108,291222,378886
"2021","대구광역시","합계",2387911,1177420,1210491
"2021","대구광역시","15~19세",111424,58469,52955
"2021","대구광역시","20~24세",158547,83644,74903
"2021","대구광역시","25~29세",162309,87198,75111
"2021","대구광역시","30~34세",138675,74734,63941
"2021","대구광역시","35~39세",150689,77251,73438
"2021","대구광역시","40~44세",175521,87145,88376
"2021","대구광역시","45~49세",193349,94993,98356
"2021","대구광역시","50~54세",216592,105452,111140
"2021","대구광역시","55~59세",199334,97690,101644
"2021","대구광역시","60~64세",194611,94073,100538
"2021","대구광역시","15세미만",273006,140256,132750
"2021","대구광역시","65세이상",413854,176515,237339
"2021","인천광역시","합계",2957044,1482202,1474842
"2021","인천광역시","15~19세",131154,67406,63748
"2021","인천광역시","20~24세",175046,91028,84018
"2021","인천광역시","25~29세",217238,114544,102694
"2021","인천광역시","30~34세",200102,105470,94632
"2021","인천광역시","35~39세",216944,113101,103843
"2021","인천광역시","40~44세",238433,123174,115259
"2021","인천광역시","45~49세",241442,123109,118333
"2021","인천광역시","50~54세",260690,128983,131707
"2021","인천광역시","55~59세",248673,123871,124802
"2021","인천광역시","60~64세",238398,118726,119672
"2021","인천광역시","15세미만",356775,183205,173570
"2021","인천광역시","65세이상",432149,189585,242564
"2021","광주광역시","합계",1475262,732088,743174
"2021","광주광역시","15~19세",77867,40062,37805
"2021","광주광역시","20~24세",111615,57114,54501
"2021","광주광역시","25~29세",108975,57475,51500
"2021","광주광역시","30~34세",87425,45429,41996
"2021","광주광역시","35~39세",100313,51200,49113
"2021","광주광역시","40~44세",115496,57517,57979
"2021","광주광역시","45~49세",123506,61806,61700
"2021","광주광역시","50~54세",128776,64241,64535
"2021","광주광역시","55~59세",111082,55676,55406
"2021","광주광역시","60~64세",104581,50920,53661
"2021","광주광역시","15세미만",189309,97380,91929
"2021","광주광역시","65세이상",216317,93268,123049
"2021","대전광역시","합계",1479740,740481,739259
"2021","대전광역시","15~19세",78502,41386,37116
"2021","대전광역시","20~24세",120355,62073,58282
"2021","대전광역시","25~29세",114451,62133,52318
"2021","대전광역시","30~34세",93871,50231,43640
"2021","대전광역시","35~39세",97511,50060,47451
"2021","대전광역시","40~44세",110452,55051,55401
"2021","대전광역시","45~49세",118451,58917,59534
"2021","대전광역시","50~54세",128354,63875,64479
"2021","대전광역시","55~59세",109814,54891,54923
"2021","대전광역시","60~64세",110624,53963,56661
"2021","대전광역시","15세미만",176486,90746,85740
"2021","대전광역시","65세이상",220869,97155,123714
"2021","울산광역시","합계",1120753,578207,542546
"2021","울산광역시","15~19세",50920,27400,23520
"2021","울산광역시","20~24세",62607,36277,26330
"2021","울산광역시","25~29세",74109,42469,31640
"2021","울산광역시","30~34세",69957,38538,31419
"2021","울산광역시","35~39세",80244,42084,38160
"2021","울산광역시","40~44세",91723,47870,43853
"2021","울산광역시","45~49세",92115,46281,45834
"2021","울산광역시","50~54세",106836,52747,54089
"2021","울산광역시","55~59세",100277,52104,48173
"2021","울산광역시","60~64세",92550,46838,45712
"2021","울산광역시","15세미만",148647,76826,71821
"2021","울산광역시","65세이상",150768,68773,81995
"2021","세종특별자치시","합계",366227,183616,182611
"2021","세종특별자치시","15~19세",19452,9719,9733
"2021","세종특별자치시","20~24세",19793,10415,9378
"2021","세종특별자치시","25~29세",21559,11192,10367
"2021","세종특별자치시","30~34세",26697,13158,13539
"2021","세종특별자치시","35~39세",34311,16848,17463
"2021","세종특별자치시","40~44세",37893,18750,19143
"2021","세종특별자치시","45~49세",32533,16889,15644
"2021","세종특별자치시","50~54세",27097,14247,12850
"2021","세종특별자치시","55~59세",20287,10434,9853
"2021","세종특별자치시","60~64세",19271,9589,9682
"2021","세종특별자치시","15세미만",71607,36428,35179
"2021","세종특별자치시","65세이상",35727,15947,19780
"2021","경기도","합계",13652529,6898723,6753806
"2021","경기도","15~19세",624696,320223,304473
"2021","경기도","20~24세",820998,430376,390622
"2021","경기도","25~29세",988655,535522,453133
"2021","경기도","30~34세",944395,503662,440733
"2021","경기도","35~39세",1048051,547566,500485
"2021","경기도","40~44세",1144257,588866,555391
"2021","경기도","45~49세",1158611,590700,567911
"2021","경기도","50~54세",1214132,608361,605771
"2021","경기도","55~59세",1071438,544215,527223
"2021","경기도","60~64세",994733,497454,497279
"2021","경기도","15세미만",1767807,905149,862658
"2021","경기도","65세이상",1874756,826629,1048127
"2021","강원특별자치도","합계",1521890,767067,754823
"2021","강원특별자치도","15~19세",68221,35983,32238
"2021","강원특별자치도","20~24세",94687,53523,41164
"2021","강원특별자치도","25~29세",89340,51264,38076
"2021","강원특별자치도","30~34세",77596,41847,35749
"2021","강원특별자치도","35~39세",86696,45071,41625
"2021","강원특별자치도","40~44세",101110,51349,49761
"2021","강원특별자치도","45~49세",113419,58337,55082
"2021","강원특별자치도","50~54세",130156,66998,63158
"2021","강원특별자치도","55~59세",127653,65062,62591
"2021","강원특별자치도","60~64세",144351,71862,72489
"2021","강원특별자치도","15세미만",164532,84493,80039
"2021","강원특별자치도","65세이상",324129,141278,182851
"2021","충청북도","합계",1624764,828073,796691
"2021","충청북도","15~19세",74333,38856,35477
"2021","충청북도","20~24세",104543,57048,47495
"2021","충청북도","25~29세",109466,63488,45978
"2021","충청북도","30~34세",96856,53699,43157
"2021","충청북도","35~39세",106838,56792,50046
"2021","충청북도","40~44세",115376,60308,55068
"2021","충청북도","45~49세",123134,63538,59596
"2021","충청북도","50~54세",139405,71068,68337
"2021","충청북도","55~59세",130685,67367,63318
"2021","충청북도","60~64세",137471,69364,68107
"2021","충청북도","15세미만",191173,98059,93114
"2021","충청북도","65세이상",295484,128486,166998
"2021","충청남도","합계",2175960,1116818,1059142
"2021","충청남도","15~19세",102279,53049,49230
"2021","충청남도","20~24세",133478,71315,62163
"2021","충청남도","25~29세",134304,77079,57225
"2021","충청남도","30~34세",132294,73946,58348
"2021","충청남도","35~39세",151521,82072,69449
"2021","충청남도","40~44세",165136,88911,76225
"2021","충청남도","45~49세",167069,88887,78182
"2021","충청남도","50~54세",178200,94286,83914
"2021","충청남도","55~59세",163026,85599,77427
"2021","충청남도","60~64세",169640,85800,83840
"2021","충청남도","15세미만",267671,137727,129944
"2021","충청남도","65세이상",411342,178147,233195
"2021","전라북도","합계",1787053,891295,895758
"2021","전라북도","15~19세",87145,46109,41036
"2021","전라북도","20~24세",118283,65327,52956
"2021","전라북도","25~29세",106105,58432,47673
"2021","전라북도","30~34세",87868,46480,41388
"2021","전라북도","35~39세",101130,51697,49433
"2021","전라북도","40~44세",119858,61185,58673
"2021","전라북도","45~49세",136383,69943,66440
"2021","전라북도","50~54세",150432,77417,73015
"2021","전라북도","55~59세",141576,72797,68779
"2021","전라북도","60~64세",148521,73674,74847
"2021","전라북도","15세미만",201102,103409,97693
"2021","전라북도","65세이상",388650,164825,223825
"2021","전라남도","합계",1778124,897120,881004
"2021","전라남도","15~19세",76785,40819,35966
"2021","전라남도","20~24세",91569,54046,37523
"2021","전라남도","25~29세",96458,55084,41374
"2021","전라남도","30~34세",83905,45424,38481
"2021","전라남도","35~39세",100987,53497,47490
"2021","전라남도","40~44세",116676,61473,55203
"2021","전라남도","45~49세",129210,68669,60541
"2021","전라남도","50~54세",150362,79895,70467
"2021","전라남도","55~59세",148699,78455,70244
"2021","전라남도","60~64세",155641,78618,77023
"2021","전라남도","15세미만",202541,103567,98974
"2021","전라남도","65세이상",425291,177573,247718
"2021","경상북도","합계",2635314,1332376,1302938
"2021","경상북도","15~19세",114129,61531,52598
"2021","경상북도","20~24세",151918,86399,65519
"2021","경상북도","25~29세",147747,85403,62344
"2021","경상북도","30~34세",137861,76992,60869
"2021","경상북도","35~39세",158775,84213,74562
"2021","경상북도","40~44세",179404,94013,85391
"2021","경상북도","45~49세",195476,101086,94390
"2021","경상북도","50~54세",223263,114704,108559
"2021","경상북도","55~59세",221816,113909,107907
"2021","경상북도","60~64세",235949,118407,117542
"2021","경상북도","15세미만",287867,148716,139151
"2021","경상북도","65세이상",581109,247003,334106
"2021","경상남도","합계",3305931,1676753,1629178
"2021","경상남도","15~19세",148364,78984,69380
"2021","경상남도","20~24세",176035,101822,74213
"2021","경상남도","25~29세",190608,108207,82401
"2021","경상남도","30~34세",183462,100773,82689
"2021","경상남도","35~39세",222205,117875,104330
"2021","경상남도","40~44세",258302,134561,123741
"2021","경상남도","45~49세",269224,138650,130574
"2021","경상남도","50~54세",298716,151376,147340
"2021","경상남도","55~59세",272262,139213,133049
"2021","경상남도","60~64세",278977,139446,139531
"2021","경상남도","15세미만",414075,213300,200775
"2021","경상남도","65세이상",593701,252546,341155
"2021","제주특별자치도","합계",673107,338809,334298
"2021","제주특별자치도","15~19세",31909,16866,15043
"2021","제주특별자치도","20~24세",37303,20293,17010
"2021","제주특별자치도","25~29세",43738,23598,20140
"2021","제주특별자치도","30~34세",39245,20353,18892
"2021","제주특별자치도","35~39세",47315,23959,23356
"2021","제주특별자치도","40~44세",54451,27548,26903
"2021","제주특별자치도","45~49세",56970,29465,27505
"2021","제주특별자치도","50~54세",59330,30681,28649
"2021","제주특별자치도","55~59세",52278,27011,25267
"2021","제주특별자치도","60~64세",47821,23988,23833
"2021","제주특별자치도","15세미만",94830,48875,45955
"2021","제주특별자치도","65세이상",107917,46172,61745
"2022","전국","합계",51692272,25835298,25856974
"2022","전국","15~19세",2303446,1190769,1112677
"2022","전국","20~24세",3054220,1597071,1457149
"2022","전국","25~29세",3622860,1930682,1692178
"2022","전국","30~34세",3435308,1825651,1609657
"2022","전국","35~39세",3437364,1788398,1648966
"2022","전국","40~44세",4047796,2075221,1972575
"2022","전국","45~49세",4018684,2037952,1980732
"2022","전국","50~54세",4513276,2273280,2239996
"2022","전국","55~59세",4076219,2044571,2031648
"2022","전국","60~64세",4176683,2058253,2118430
"2022","전국","15세미만",5859928,3007414,2852514
"2022","전국","65세이상",9146488,4006036,5140452
"2022","서울특별시","합계",9417469,4547051,4870418
"2022","서울특별시","15~19세",377893,190040,187853
"2022","서울특별시","20~24세",612987,278436,334551
"2022","서울특별시","25~29세",826149,395825,430324
"2022","서울특별시","30~34세",756436,378100,378336
"2022","서울특별시","35~39세",673243,338321,334922
"2022","서울특별시","40~44세",720845,360369,360476
"2022","서울특별시","45~49세",706120,349142,356978
"2022","서울특별시","50~54세",794846,390992,403854
"2022","서울특별시","55~59세",700391,340868,359523
"2022","서울특별시","60~64세",722186,342785,379401
"2022","서울특별시","15세미만",887125,455864,431261
"2022","서울특별시","65세이상",1639248,726309,912939
"2022","부산광역시","합계",3295760,1608947,1686813
"2022","부산광역시","15~19세",131316,67720,63596
"2022","부산광역시","20~24세",194156,100034,94122
"2022","부산광역시","25~29세",218324,114162,104162
"2022","부산광역시","30~34세",201175,104898,96277
"2022","부산광역시","35~39세",198745,102180,96565
"2022","부산광역시","40~44세",246962,125754,121208
"2022","부산광역시","45~49세",238052,119346,118706
"2022","부산광역시","50~54세",274172,134160,140012
"2022","부산광역시","55~59세",259060,124174,134886
"2022","부산광역시","60~64세",296958,139305,157653
"2022","부산광역시","15세미만",334985,171881,163104
"2022","부산광역시","65세이상",701855,305333,396522
"2022","대구광역시","합계",2366852,1165698,1201154
"2022","대구광역시","15~19세",109163,56862,52301
"2022","대구광역시","20~24세",146632,77965,68667
"2022","대구광역시","25~29세",157767,83833,73934
"2022","대구광역시","30~34세",142967,77239,65728
"2022","대구광역시","35~39세",141704,73569,68135
"2022","대구광역시","40~44세",176711,87720,88991
"2022","대구광역시","45~49세",185351,91090,94261
"2022","대구광역시","50~54세",215150,105121,110029
"2022","대구광역시","55~59세",197552,96201,101351
"2022","대구광역시","60~64세",197979,95477,102502
"2022","대구광역시","15세미만",262796,134926,127870
"2022","대구광역시","65세이상",433080,185695,247385
"2022","인천광역시","합계",2989125,1499105,1490020
"2022","인천광역시","15~19세",132701,68236,64465
"2022","인천광역시","20~24세",166160,87029,79131
"2022","인천광역시","25~29세",214799,113241,101558
"2022","인천광역시","30~34세",212250,112307,99943
"2022","인천광역시","35~39세",210038,109700,100338
"2022","인천광역시","40~44세",246425,127633,118792
"2022","인천광역시","45~49세",237223,121130,116093
"2022","인천광역시","50~54세",264359,131642,132717
"2022","인천광역시","55~59세",246507,122032,124475
"2022","인천광역시","60~64세",247820,123143,124677
"2022","인천광역시","15세미만",349247,179102,170145
"2022","인천광역시","65세이상",461596,203910,257686
"2022","광주광역시","합계",1468972,728859,740113
"2022","광주광역시","15~19세",76904,39589,37315
"2022","광주광역시","20~24세",105779,54043,51736
"2022","광주광역시","25~29세",108556,57332,51224
"2022","광주광역시","30~34세",90878,47394,43484
"2022","광주광역시","35~39세",93391,47642,45749
"2022","광주광역시","40~44세",116704,58287,58417
"2022","광주광역시","45~49세",119662,59786,59876
"2022","광주광역시","50~54세",130377,65123,65254
"2022","광주광역시","55~59세",112303,56153,56150
"2022","광주광역시","60~64세",106112,51641,54471
"2022","광주광역시","15세미만",182082,93697,88385
"2022","광주광역시","65세이상",226224,98172,128052
"2022","대전광역시","합계",1473662,737127,736535
"2022","대전광역시","15~19세",78421,41074,37347
"2022","대전광역시","20~24세",114288,59231,55057
"2022","대전광역시","25~29세",114309,61872,52437
"2022","대전광역시","30~34세",97278,51959,45319
"2022","대전광역시","35~39세",92298,47723,44575
"2022","대전광역시","40~44세",110342,55124,55218
"2022","대전광역시","45~49세",114827,56843,57984
"2022","대전광역시","50~54세",128748,64212,64536
"2022","대전광역시","55~59세",108680,54172,54508
"2022","대전광역시","60~64세",112458,54746,57712
"2022","대전광역시","15세미만",169677,87321,82356
"2022","대전광역시","65세이상",232336,102850,129486
"2022","울산광역시","합계",1110516,573080,537436
"2022","울산광역시","15~19세",50564,27077,23487
"2022","울산광역시","20~24세",56591,32929,23662
"2022","울산광역시","25~29세",71995,41431,30564
"2022","울산광역시","30~34세",70718,39353,31365
"2022","울산광역시","35~39세",74606,39559,35047
"2022","울산광역시","40~44세",92553,48183,44370
"2022","울산광역시","45~49세",89379,45295,44084
"2022","울산광역시","50~54세",105043,51982,53061
"2022","울산광역시","55~59세",100257,51488,48769
"2022","울산광역시","60~64세",95241,48382,46859
"2022","울산광역시","15세미만",141863,73157,68706
"2022","울산광역시","65세이상",161706,74244,87462
"2022","세종특별자치시","합계",382589,192165,190424
"2022","세종특별자치시","15~19세",21845,10937,10908
"2022","세종특별자치시","20~24세",21524,11496,10028
"2022","세종특별자치시","25~29세",21977,11599,10378
"2022","세종특별자치시","30~34세",27717,13719,13998
"2022","세종특별자치시","35~39세",33398,16464,16934
"2022","세종특별자치시","40~44세",40300,19902,20398
"2022","세종특별자치시","45~49세",34218,17420,16798
"2022","세종특별자치시","50~54세",29285,15506,13779
"2022","세종특별자치시","55~59세",21304,10963,10341
"2022","세종특별자치시","60~64세",20345,10087,10258
"2022","세종특별자치시","15세미만",72186,36735,35451
"2022","세종특별자치시","65세이상",38490,17337,21153
"2022","경기도","합계",13717827,6938563,6779264
"2022","경기도","15~19세",625253,319929,305324
"2022","경기도","20~24세",776298,409774,366524
"2022","경기도","25~29세",978558,530901,447657
"2022","경기도","30~34세",979421,526297,453124
"2022","경기도","35~39세",1002528,526009,476519
"2022","경기도","40~44세",1169885,603808,566077
"2022","경기도","45~49세",1133292,577092,556200
"2022","경기도","50~54세",1239256,624071,615185
"2022","경기도","55~59세",1077464,543707,533757
"2022","경기도","60~64세",1030808,515715,515093
"2022","경기도","15세미만",1713967,877303,836664
"2022","경기도","65세이상",1991097,883957,1107140
"2022","강원특별자치도","합계",1528037,770518,757519
"2022","강원특별자치도","15~19세",67850,35912,31938
"2022","강원특별자치도","20~24세",91657,51836,39821
"2022","강원특별자치도","25~29세",89638,51288,38350
"2022","강원특별자치도","30~34세",81227,44130,37097
"2022","강원특별자치도","35~39세",82413,43163,39250
"2022","강원특별자치도","40~44세",102610,52063,50547
"2022","강원특별자치도","45~49세",110161,56316,53845
"2022","강원특별자치도","50~54세",130218,67343,62875
"2022","강원특별자치도","55~59세",126085,64070,62015
"2022","강원특별자치도","60~64세",146001,72525,73476
"2022","강원특별자치도","15세미만",159135,81697,77438
"2022","강원특별자치도","65세이상",341042,150175,190867
"2022","충청북도","합계",1624993,830923,794070
"2022","충청북도","15~19세",73194,38189,35005
"2022","충청북도","20~24세",97068,53724,43344
"2022","충청북도","25~29세",109537,63281,46256
"2022","충청북도","30~34세",100144,56755,43389
"2022","충청북도","35~39세",101738,54715,47023
"2022","충청북도","40~44세",117988,61825,56163
"2022","충청북도","45~49세",121191,62471,58720
"2022","충청북도","50~54세",138406,70932,67474
"2022","충청북도","55~59세",130260,66920,63340
"2022","충청북도","60~64세",140699,71233,69466
"2022","충청북도","15세미만",183445,94103,89342
"2022","충청북도","65세이상",311323,136775,174548
"2022","충청남도","합계",2193214,1128115,1065099
"2022","충청남도","15~19세",105486,54917,50569
"2022","충청남도","20~24세",132325,70998,61327
"2022","충청남도","25~29세",133729,77078,56651
"2022","충청남도","30~34세",134873,76109,58764
"2022","충청남도","35~39세",144867,78879,65988
"2022","충청남도","40~44세",169822,91478,78344
"2022","충청남도","45~49세",165907,88061,77846
"2022","충청남도","50~54세",180477,95922,84555
"2022","충청남도","55~59세",163134,85385,77749
"2022","충청남도","60~64세",175472,89069,86403
"2022","충청남도","15세미만",258220,132655,125565
"2022","충청남도","65세이상",428902,187564,241338
"2022","전라북도","합계",1774248,885708,888540
"2022","전라북도","15~19세",86048,45376,40672
"2022","전라북도","20~24세",111284,61905,49379
"2022","전라북도","25~29세",105436,58230,47206
"2022","전라북도","30~34세",90187,48108,42079
"2022","전라북도","35~39세",94712,48683,46029
"2022","전라북도","40~44세",119659,61091,58568
"2022","전라북도","45~49세",132136,67424,64712
"2022","전라북도","50~54세",150934,78015,72919
"2022","전라북도","55~59세",140738,72149,68589
"2022","전라북도","60~64세",150482,74799,75683
"2022","전라북도","15세미만",191118,98039,93079
"2022","전라북도","65세이상",401514,171889,229625
"2022","전라남도","합계",1771431,896174,875257
"2022","전라남도","15~19세",75057,39867,35190
"2022","전라남도","20~24세",85505,50732,34773
"2022","전라남도","25~29세",97569,56379,41190
"2022","전라남도","30~34세",86907,47867,39040
"2022","전라남도","35~39세",94443,50045,44398
"2022","전라남도","40~44세",117945,62443,55502
"2022","전라남도","45~49세",125181,66111,59070
"2022","전라남도","50~54세",149908,79664,70244
"2022","전라남도","55~59세",149390,78853,70537
"2022","전라남도","60~64세",157952,80276,77676
"2022","전라남도","15세미만",193798,99140,94658
"2022","전라남도","65세이상",437776,184797,252979
"2022","경상북도","합계",2620373,1327631,1292742
"2022","경상북도","15~19세",112771,60497,52274
"2022","경상북도","20~24세",143505,82469,61036
"2022","경상북도","25~29세",145515,84708,60807
"2022","경상북도","30~34세",138625,78014,60611
"2022","경상북도","35~39세",148728,79554,69174
"2022","경상북도","40~44세",181623,95248,86375
"2022","경상북도","45~49세",189253,97592,91661
"2022","경상북도","50~54세",222620,114933,107687
"2022","경상북도","55~59세",219213,112209,107004
"2022","경상북도","60~64세",240510,121039,119471
"2022","경상북도","15세미만",274689,141866,132823
"2022","경상북도","65세이상",603321,259502,343819
"2022","경상남도","합계",3280829,1664969,1615860
"2022","경상남도","15~19세",146999,77820,69179
"2022","경상남도","20~24세",163323,95048,68275
"2022","경상남도","25~29세",185570,106007,79563
"2022","경상남도","30~34세",183847,101988,81859
"2022","경상남도","35~39세",205804,109537,96267
"2022","경상남도","40~44세",261142,135915,125227
"2022","경상남도","45~49세",261180,134141,127039
"2022","경상남도","50~54세",298337,152182,146155
"2022","경상남도","55~59세",270732,137739,132993
"2022","경상남도","60~64세",286351,143352,142999
"2022","경상남도","15세미만",393584,202540,191044
"2022","경상남도","65세이상",623960,268700,355260
"2022","제주특별자치도","합계",676375,340665,335710
"2022","제주특별자치도","15~19세",31981,16727,15254
"2022","제주특별자치도","20~24세",35138,19422,15716
"2022","제주특별자치도","25~29세",43432,23515,19917
"2022","제주특별자치도","30~34세",40658,21414,19244
"2022","제주특별자치도","35~39세",44708,22655,22053
"2022","제주특별자치도","40~44세",56280,28378,27902
"2022","제주특별자치도","45~49세",55551,28692,26859
"2022","제주특별자치도","50~54세",61140,31480,29660
"2022","제주특별자치도","55~59세",53149,27488,25661
"2022","제주특별자치도","60~64세",49309,24679,24630
"2022","제주특별자치도","15세미만",92011,47388,44623
"2022","제주특별자치도","65세이상",113018,48827,64191
"2023","전국","합계",51774521,25903852,25870669
"2023","전국","15~19세",2298339,1186270,1112069
"2023","전국","20~24세",2915658,1529757,1385901
"2023","전국","25~29세",3579935,1907333,1672602
"2023","전국","30~34세",3557870,1905868,1652002
"2023","전국","35~39세",3333907,1745532,1588375
"2023","전국","40~44세",4083172,2097082,1986090
"2023","전국","45~49세",3894494,1981666,1912828
"2023","전국","50~54세",4482461,2262196,2220265
"2023","전국","55~59세",4153074,2073954,2079120
"2023","전국","60~64세",4247204,2098812,2148392
"2023","전국","15세미만",5619426,2883426,2736000
"2023","전국","65세이상",9608981,4231956,5377025
"2023","서울특별시","합계",9384512,4523958,4860554
"2023","서울특별시","15~19세",374406,188068,186338
"2023","서울특별시","20~24세",589635,266615,323020
"2023","서울특별시","25~29세",818359,387526,430833
"2023","서울특별시","30~34세",778852,390430,388422
"2023","서울특별시","35~39세",654497,328810,325687
"2023","서울특별시","40~44세",724780,362514,362266
"2023","서울특별시","45~49세",677141,335295,341846
"2023","서울특별시","50~54세",787621,388356,399265
"2023","서울특별시","55~59세",702345,340868,361477
"2023","서울특별시","60~64세",721895,344134,377761
"2023","서울특별시","15세미만",840357,431533,408824
"2023","서울특별시","65세이상",1714624,759809,954815
"2023","부산광역시","합계",3279604,1600281,1679323
"2023","부산광역시","15~19세",131007,67257,63750
"2023","부산광역시","20~24세",184866,95236,89630
"2023","부산광역시","25~29세",210961,109669,101292
"2023","부산광역시","30~34세",206459,108414,98045
"2023","부산광역시","35~39세",190244,98253,91991
"2023","부산광역시","40~44세",247355,125768,121587
"2023","부산광역시","45~49세",230346,116255,114091
"2023","부산광역시","50~54세",269435,132388,137047
"2023","부산광역시","55~59세",259256,124080,135176
"2023","부산광역시","60~64세",293765,137821,155944
"2023","부산광역시","15세미만",322209,165391,156818
"2023","부산광역시","65세이상",733701,319749,413952
"2023","대구광역시","합계",2379188,1170854,1208334
"2023","대구광역시","15~19세",107254,55598,51656
"2023","대구광역시","20~24세",138068,73411,64657
"2023","대구광역시","25~29세",153687,81427,72260
"2023","대구광역시","30~34세",148950,80481,68469
"2023","대구광역시","35~39세",137067,72398,64669
"2023","대구광역시","40~44세",177772,88276,89496
"2023","대구광역시","45~49세",178332,88123,90209
"2023","대구광역시","50~54세",212486,103592,108894
"2023","대구광역시","55~59세",203085,98867,104218
"2023","대구광역시","60~64세",205536,98957,106579
"2023","대구광역시","15세미만",254403,130465,123938
"2023","대구광역시","65세이상",462548,199259,263289
"2023","인천광역시","합계",3025950,1518154,1507796
"2023","인천광역시","15~19세",132676,68199,64477
"2023","인천광역시","20~24세",157298,82599,74699
"2023","인천광역시","25~29세",210265,110638,99627
"2023","인천광역시","30~34세",223469,118812,104657
"2023","인천광역시","35~39세",208503,109528,98975
"2023","인천광역시","40~44세",253034,131451,121583
"2023","인천광역시","45~49세",233181,119618,113563
"2023","인천광역시","50~54세",264244,132158,132086
"2023","인천광역시","55~59세",250604,122993,127611
"2023","인천광역시","60~64세",255466,126793,128673
"2023","인천광역시","15세미만",341938,175403,166535
"2023","인천광역시","65세이상",495272,219962,275310
"2023","광주광역시","합계",1457090,722226,734864
"2023","광주광역시","15~19세",75170,38683,36487
"2023","광주광역시","20~24세",99376,51267,48109
"2023","광주광역시","25~29세",106455,56182,50273
"2023","광주광역시","30~34세",93658,49213,44445
"2023","광주광역시","35~39세",87663,44786,42877
"2023","광주광역시","40~44세",116220,58221,57999
"2023","광주광역시","45~49세",115092,57504,57588
"2023","광주광역시","50~54세",128969,64168,64801
"2023","광주광역시","55~59세",115134,57206,57928
"2023","광주광역시","60~64세",108366,52825,55541
"2023","광주광역시","15세미만",173657,89180,84477
"2023","광주광역시","65세이상",237330,102991,134339
"2023","대전광역시","합계",1470336,735804,734532
"2023","대전광역시","15~19세",76680,40074,36606
"2023","대전광역시","20~24세",110397,57650,52747
"2023","대전광역시","25~29세",113406,61115,52291
"2023","대전광역시","30~34세",100474,53663,46811
"2023","대전광역시","35~39세",89369,46538,42831
"2023","대전광역시","40~44세",109939,55170,54769
"2023","대전광역시","45~49세",110096,54553,55543
"2023","대전광역시","50~54세",127073,63442,63631
"2023","대전광역시","55~59세",112814,55956,56858
"2023","대전광역시","60~64세",113102,55250,57852
"2023","대전광역시","15세미만",162571,83713,78858
"2023","대전광역시","65세이상",244415,108680,135735
"2023","울산광역시","합계",1107432,573506,533926
"2023","울산광역시","15~19세",50520,26929,23591
"2023","울산광역시","20~24세",52179,30751,21428
"2023","울산광역시","25~29세",70532,41019,29513
"2023","울산광역시","30~34세",72836,41254,31582
"2023","울산광역시","35~39세",71357,38644,32713
"2023","울산광역시","40~44세",92922,48464,44458
"2023","울산광역시","45~49세",86753,44518,42235
"2023","울산광역시","50~54세",102249,50738,51511
"2023","울산광역시","55~59세",102135,51857,50278
"2023","울산광역시","60~64세",97533,49697,47836
"2023","울산광역시","15세미만",135018,69631,65387
"2023","울산광역시","65세이상",173398,80004,93394
"2023","세종특별자치시","합계",386261,193999,192262
"2023","세종특별자치시","15~19세",22820,11478,11342
"2023","세종특별자치시","20~24세",21275,11305,9970
"2023","세종특별자치시","25~29세",21471,11242,10229
"2023","세종특별자치시","30~34세",27713,13852,13861
"2023","세종특별자치시","35~39세",32169,16077,16092
"2023","세종특별자치시","40~44세",41019,20078,20941
"2023","세종특별자치시","45~49세",34911,17654,17257
"2023","세종특별자치시","50~54세",30625,16181,14444
"2023","세종특별자치시","55~59세",22451,11568,10883
"2023","세종특별자치시","60~64세",20756,10371,10385
"2023","세종특별자치시","15세미만",70310,35805,34505
"2023","세종특별자치시","65세이상",40741,18388,22353
"2023","경기도","합계",13815367,6994451,6820916
"2023","경기도","15~19세",630892,322841,308051
"2023","경기도","20~24세",740139,391489,348650
"2023","경기도","25~29세",967222,525598,441624
"2023","경기도","30~34세",1014680,549522,465158
"2023","경기도","35~39세",979277,516066,463211
"2023","경기도","40~44세",1186574,614013,572561
"2023","경기도","45~49세",1107103,565830,541273
"2023","경기도","50~54세",1241361,626796,614565
"2023","경기도","55~59세",1106313,554232,552081
"2023","경기도","60~64세",1064833,533223,531610
"2023","경기도","15세미만",1654215,846658,807557
"2023","경기도","65세이상",2122758,948183,1174575
"2023","강원특별자치도","합계",1528014,770824,757190
"2023","강원특별자치도","15~19세",67019,35176,31843
"2023","강원특별자치도","20~24세",87432,49414,38018
"2023","강원특별자치도","25~29세",89090,50911,38179
"2023","강원특별자치도","30~34세",84252,46274,37978
"2023","강원특별자치도","35~39세",79752,42120,37632
"2023","강원특별자치도","40~44세",102435,52198,50237
"2023","강원특별자치도","45~49세",105658,53784,51874
"2023","강원특별자치도","50~54세",128042,66110,61932
"2023","강원특별자치도","55~59세",127742,64918,62824
"2023","강원특별자치도","60~64세",146195,72849,73346
"2023","강원특별자치도","15세미만",152473,78253,74220
"2023","강원특별자치도","65세이상",357924,158817,199107
"2023","충청북도","합계",1641481,842776,798705
"2023","충청북도","15~19세",74640,39046,35594
"2023","충청북도","20~24세",98679,55314,43365
"2023","충청북도","25~29세",110177,63804,46373
"2023","충청북도","30~34세",105710,60880,44830
"2023","충청북도","35~39세",99576,54092,45484
"2023","충청북도","40~44세",119451,62816,56635
"2023","충청북도","45~49세",117136,60537,56599
"2023","충청북도","50~54세",136563,70308,66255
"2023","충청북도","55~59세",134773,68591,66182
"2023","충청북도","60~64세",141408,71772,69636
"2023","충청북도","15세미만",176396,90424,85972
"2023","충청북도","65세이상",326972,145192,181780
"2023","충청남도","합계",2216332,1144200,1072132
"2023","충청남도","15~19세",106679,55438,51241
"2023","충청남도","20~24세",128133,69258,58875
"2023","충청남도","25~29세",135427,79040,56387
"2023","충청남도","30~34세",140362,80040,60322
"2023","충청남도","35~39세",142665,78208,64457
"2023","충청남도","40~44세",173614,93479,80135
"2023","충청남도","45~49세",163642,87267,76375
"2023","충청남도","50~54세",181830,96956,84874
"2023","충청남도","55~59세",169230,88253,80977
"2023","충청남도","60~64세",179892,91927,87965
"2023","충청남도","15세미만",248594,127873,120721
"2023","충청남도","65세이상",446264,196461,249803
"2023","전라북도","합계",1768491,884098,884393
"2023","전라북도","15~19세",84259,44490,39769
"2023","전라북도","20~24세",105732,58718,47014
"2023","전라북도","25~29세",105782,58649,47133
"2023","전라북도","30~34세",93676,50508,43168
"2023","전라북도","35~39세",90756,46899,43857
"2023","전라북도","40~44세",118867,60845,58022
"2023","전라북도","45~49세",126891,64831,62060
"2023","전라북도","50~54세",150209,77538,72671
"2023","전라북도","55~59세",143957,73731,70226
"2023","전라북도","60~64세",153073,76572,76501
"2023","전라북도","15세미만",181477,92944,88533
"2023","전라북도","65세이상",413812,178373,235439
"2023","전라남도","합계",1776668,903776,872892
"2023","전라남도","15~19세",74094,39152,34942
"2023","전라남도","20~24세",81356,48916,32440
"2023","전라남도","25~29세",99022,57790,41232
"2023","전라남도","30~34세",93156,52331,40825
"2023","전라남도","35~39세",91384,49021,42363
"2023","전라남도","40~44세",119301,63359,55942
"2023","전라남도","45~49세",121073,64189,56884
"2023","전라남도","50~54세",147946,78522,69424
"2023","전라남도","55~59세",151382,80226,71156
"2023","전라남도","60~64세",161429,82574,78855
"2023","전라남도","15세미만",185660,94962,90698
"2023","전라남도","65세이상",450865,192734,258131
"2023","경상북도","합계",2589880,1317564,1272316
"2023","경상북도","15~19세",111648,59851,51797
"2023","경상북도","20~24세",135551,79331,56220
"2023","경상북도","25~29세",143234,84205,59029
"2023","경상북도","30~34세",141597,80624,60973
"2023","경상북도","35~39세",141534,76794,64740
"2023","경상북도","40~44세",181830,95443,86387
"2023","경상북도","45~49세",180923,93765,87158
"2023","경상북도","50~54세",216470,111925,104545
"2023","경상북도","55~59세",220062,112463,107599
"2023","경상북도","60~64세",241631,121997,119634
"2023","경상북도","15세미만",259939,134180,125759
"2023","경상북도","65세이상",615461,266986,348475
"2023","경상남도","합계",3271148,1665898,1605250
"2023","경상남도","15~19세",146747,77328,69419
"2023","경상남도","20~24세",152673,90017,62656
"2023","경상남도","25~29세",182669,105449,77220
"2023","경상남도","30~34세",189346,106895,82451
"2023","경상남도","35~39세",195600,105571,90029
"2023","경상남도","40~44세",260891,136194,124697
"2023","경상남도","45~49세",252376,130158,122218
"2023","경상남도","50~54세",295532,151293,144239
"2023","경상남도","55~59세",277438,140071,137367
"2023","경상남도","60~64세",290752,146146,144606
"2023","경상남도","15세미만",372519,191937,180582
"2023","경상남도","65세이상",654605,284839,369766
"2023","제주특별자치도","합계",676767,341483,335284
"2023","제주특별자치도","15~19세",31828,16662,15166
"2023","제주특별자치도","20~24세",32869,18466,14403
"2023","제주특별자치도","25~29세",42176,23069,19107
"2023","제주특별자치도","30~34세",42680,22675,20005
"2023","제주특별자치도","35~39세",42494,21727,20767
"2023","제주특별자치도","40~44세",57168,28793,28375
"2023","제주특별자치도","45~49세",53840,27785,26055
"2023","제주특별자치도","50~54세",61806,31725,30081
"2023","제주특별자치도","55~59세",54353,28074,26279
"2023","제주특별자치도","60~64세",51572,25904,25668
"2023","제주특별자치도","15세미만",87690,45074,42616
"2023","제주특별자치도","65세이상",118291,51529,66762
